game,release,peak_players,positive_reviews,negative_reviews,total_reviews,rating,players_right_now
Pizza Tower,2023-01-26,4529,19807,227,20034,96.39,"3,101"
Resident Evil 4,2023-03-24,168191,61752,1616,63368,95.75,"46,289"
The Murder of Sonic the Hedgehog,2023-03-31,15543,12643,213,12856,95.54,618
Pineapple on pizza,2023-03-28,1415,11717,209,11926,95.39,101
Hi-Fi RUSH,2023-01-25,6132,14152,324,14476,95.09,630
东北之夏,2023-01-09,8672,8891,165,9056,95.08,62
Crab Champions,2023-04-01,8564,5129,81,5210,94.76,"4,142"
Papa's Freezeria Deluxe,2023-03-31,1227,1832,20,1852,93.84,661
A Space for the Unbound,2023-01-19,338,1917,27,1944,93.64,63
Handshakes,2023-01-13,195,1166,10,1176,93.3,8
候鸟,2023-01-11,162,1149,12,1161,93.12,19
Симулятор Побега от Военкомата,2023-04-03,775,1995,42,2037,93.1,127
I commissioned some bees 0,2023-01-12,374,1733,36,1769,92.92,21
Spin Rhythm XD,2023-03-14,313,2909,86,2995,92.89,57
OCTOPATH TRAVELER II,2023-02-24,17008,4403,158,4561,92.85,"3,206"
Boneraiser Minions,2023-03-09,2029,3093,97,3190,92.82,332
Bloody Hell,2023-01-27,395,1308,22,1330,92.8,60
DREDGE,2023-03-30,12686,5632,234,5866,92.63,"7,523"
Your Only Move Is HUSTLE,2023-02-02,3405,5664,245,5909,92.5,745
Touhou Hero of Ice Fairy,2023-02-25,573,736,8,744,92.24,69
Your Turn To Die -Death Game By Majority- ,2023-02-20,471,616,4,620,92.23,39
DR LIVESEY ROM AND DEATH EDITION,2023-02-13,818,4397,221,4618,91.65,43
Half-Life: MMod,2023-03-14,1027,1222,39,1261,91.44,90
Hogwarts Legacy,2023-02-10,879308,179479,14684,194163,91.35,"34,741"
Big Ambitions,2023-03-10,10961,3976,218,4194,91.17,"2,913"
Apewar,2023-03-24,361,1313,50,1363,91.06,91
Meg's Monster,2023-03-02,195,484,7,491,91.06,18
The Test: Secrets of the Soul,2023-02-20,16,527,9,536,91.04,2
Barotrauma,2023-03-13,19655,41677,3286,44963,90.99,"7,552"
觅长生,2023-01-13,26379,17906,1323,19229,90.91,"3,942"
Birth,2023-02-17,183,442,7,449,90.74,23
Contraband Police,2023-03-08,8124,4519,282,4801,90.69,"1,558"
Bing in Wonderland,2023-01-13,977,1184,48,1232,90.69,97
Luck be a Landlord,2023-01-06,2544,6625,459,7084,90.5,408
Durka Simulator,2023-03-21,48,1598,80,1678,90.4,3
 Dead Space,2023-01-27,30925,21792,1820,23612,90.25,761
PARANORMASIGHT: The Seven Mysteries of Honjo,2023-03-08,582,654,24,678,89.93,124
Patch Quest,2023-03-02,2356,1357,72,1429,89.92,119
Vertigo 2,2023-03-30,295,497,15,512,89.88,78
Larcin Lazer,2023-01-24,38,223,1,224,89.85,1
Fallen Hero: Retribution,2023-02-02,379,242,2,244,89.79,11
Scarlet Maiden,2023-01-27,736,895,42,937,89.72,66
Landfall Archives,2023-03-31,1247,695,29,724,89.66,155
Elong Plug,2023-02-25,34,231,2,233,89.63,2
The Symbiant,2023-02-02,120,284,5,289,89.51,4
Shogun Showdown: Prologue,2023-04-04,590,274,5,279,89.37,82
流光易逝的夏末 - Fleeting Summer's End,2023-01-06,22,165,0,165,89.27,0
Lake Haven - Chrysalis,2023-01-18,24,246,4,250,89.23,0
The Legend of Heroes: Trails to Azure,2023-03-14,884,183,1,184,89.18,318
Half-Life 2: VR Mod - Episode One,2023-03-17,193,237,4,241,89.08,39
q.u.q.,2023-02-27,24,283,7,290,88.96,8
The Last Spell,2023-03-09,6755,7268,659,7927,88.89,"1,837"
EMPTY SHELL: PROLOGUE,2023-01-06,130,628,31,659,88.88,4
Sifu,2023-03-28,3189,1727,125,1852,88.76,960
方寸文明,2023-01-01,1414,787,45,832,88.7,111
Crimson Snow,2023-03-29,103,758,43,801,88.67,9
通神榜 Noobs Want to Live,2023-02-14,8622,3135,263,3398,88.61,641
스테퍼 케이스: 초능력 추리 어드벤처,2023-03-10,134,242,6,248,88.54,50
Ages of Conflict: World War Simulator,2023-02-17,312,442,20,462,88.47,183
RHYTHM SPROUT,2023-02-01,204,311,11,322,88.4,7
Mortal Sin,2023-03-15,191,280,9,289,88.38,14
Figment 2: Creed Valley,2023-03-09,62,183,3,186,88.37,3
Locke(d),2023-01-23,30,470,23,493,88.33,1
Cultivation Story: Reincarnation,2023-01-30,1626,1392,104,1496,88.28,157
Gorilla Tag,2023-01-01,1679,26120,2876,28996,88.26,"1,154"
SpongeBob SquarePants: The Cosmic Shake,2023-01-31,1949,1203,88,1291,88.19,43
Can of Wormholes,2023-03-24,165,138,1,139,88.15,49
Love Love School Days,2023-02-06,277,316,13,329,88.01,21
Die in the Dungeon PROLOGUE,2023-01-12,379,311,13,324,87.92,16
Season,2023-01-31,461,747,50,797,87.88,24
Halls of Torment Prelude,2023-03-09,1080,597,37,634,87.83,129
挂机神话,2023-04-07,1142,1326,107,1433,87.76,480
Demons Roots,2023-01-14,612,575,36,611,87.72,54
24 Killers,2023-03-09,29,105,0,105,87.72,1
Demonologist,2023-03-27,8806,2737,259,2996,87.64,"4,463"
Mr. Saitou,2023-03-23,61,214,7,221,87.62,1
Aliens After Ava,2023-01-13,14,119,1,120,87.56,0
The Light Brigade,2023-02-22,156,445,26,471,87.51,30
SkyIsland,2023-02-15,216,478,29,507,87.49,9
HOPE LEFT ME,2023-03-10,14,150,3,153,87.49,0
Creepy Tale 3: Ingrid Penance,2023-03-09,121,165,4,169,87.48,22
VOYAGER,2023-03-25,9,116,1,117,87.46,1
Plasma,2023-03-30,358,161,4,165,87.36,60
NOeSIS Ⅱ-人间无常,2023-02-26,17,113,1,114,87.35,1
memories,2023-02-03,38,376,21,397,87.34,2
Pleh!,2023-03-17,124,315,16,331,87.3,7
Sun Haven,2023-03-11,12706,5357,587,5944,87.19,"4,651"
Atelier Ryza 3: Alchemist of the End & the Secret Key,2023-03-24,7162,717,54,771,87.19,"2,029"
Above Snakes: Prologue,2023-03-24,3672,1116,95,1211,87.18,102
Metroplex Zero,2023-03-31,16,91,0,91,87.18,0
SimRail - The Railway Simulator,2023-01-13,1914,1253,110,1363,87.16,419
SpunkStock: Music Festival,2023-01-26,277,165,5,170,87.05,4
Farlanders,2023-01-17,251,313,17,330,87.03,9
Clash: Artifacts of Chaos,2023-03-09,148,306,17,323,86.89,10
Glory & Miserable Survivors DX,2023-03-16,776,390,26,416,86.63,117
Soundodger 2,2023-04-10,53,109,2,111,86.55,11
Caves of Lore,2023-01-21,103,148,5,153,86.47,10
Lone Fungus,2023-04-07,214,194,9,203,86.38,175
Passpartout 2: The Lost Artist,2023-04-04,591,272,16,288,86.37,267
A Bavarian Tale - Totgeschwiegen,2023-02-02,57,144,5,149,86.32,7
Coralina,2023-01-06,16,192,9,201,86.31,0
King Of The Castle,2023-03-02,321,488,38,526,86.29,24
ZED ZONE,2023-03-30,2569,1332,135,1467,86.25,865
Omega Strikers,2023-04-27,19257,10006,1292,11298,86.24,10
BETON BRUTAL,2023-03-31,147,129,4,133,86.24,64
ENTROPOLY,2023-03-02,41,102,2,104,86.23,0
ふりかけ☆スペイシー,2023-03-01,48,71,0,71,86.2,3
Cannibal Abduction,2023-01-13,25,138,5,143,86.09,0
Graze Counter GM,2023-01-18,72,84,1,85,86.05,1
The Multi-Medium,2023-01-20,15,84,1,85,86.05,0
Basements n' Basilisks: Storms of Sorcery,2023-02-27,20,98,2,100,86.04,0
Partum Artifex,2023-02-26,17,83,1,84,86.0,0
Plan B: Terraform,2023-02-15,2352,1072,108,1180,85.99,168
Dreams in the Witch House,2023-02-16,42,123,4,127,85.98,3
Planet Cube: Edge,2023-02-23,14,97,2,99,85.98,0
The Pale Beyond,2023-02-24,738,731,68,799,85.94,27
Kujlevka,2023-04-06,73,82,1,83,85.94,16
vivid/stasis,2023-03-07,53,109,3,112,85.92,13
Aces and Adventures,2023-02-23,2455,879,87,966,85.82,103
Tower Tactics: Liberation,2023-02-06,808,751,72,823,85.79,77
一起击碎吧,2023-04-06,28,62,0,62,85.63,0
Time Wasters,2023-03-10,934,695,67,762,85.62,280
Kandria,2023-01-11,26,90,2,92,85.61,1
Juno: New Origins,2023-01-26,780,1953,229,2182,85.6,128
Hell Of An Office,2023-03-14,26,76,1,77,85.58,1
Confabulation,2023-01-13,13,61,0,61,85.57,0
Good Pizza Great Pizza,2023-01-06,145,1453,164,1617,85.55,80
Lords of Infinity,2023-03-02,270,114,4,118,85.55,8
Apex Point,2023-03-05,385,604,57,661,85.52,84
Looking Up I See Only A Ceiling,2023-03-09,12,147,7,154,85.5,1
Magic Tower & Maidens,2023-02-27,61,124,5,129,85.47,0
Robolife2-Nova Duty,2023-03-11,892,313,24,337,85.45,118
Revenant,2023-03-29,20,74,1,75,85.45,4
Crafty Survivors,2023-03-15,374,198,12,210,85.44,45
Emberfate: Tempest of Elements,2023-01-27,21,59,0,59,85.42,1
DIG - Deep In Galaxies,2023-03-08,40,73,1,74,85.39,5
與經紀人戀愛是絕對禁止2,2023-03-12,518,264,19,283,85.38,81
It Comes In Waves,2023-04-05,19,86,2,88,85.37,1
Weird and Unfortunate Things Are Happening,2023-02-06,29,58,0,58,85.35,2
EVERSPACE™ 2,2023-04-06,9760,5400,732,6132,85.31,"7,670"
SHUFFLE! Episode 2 ~Kami ni mo Akuma ni mo Nerawareteiru Otoko~,2023-03-10,89,120,5,125,85.27,13
Handyman Legend,2023-03-10,1002,484,45,529,85.21,117
觅光：第一章 - Seeking Light : Chapter 1,2023-03-25,28,56,0,56,85.2,5
Postmouse,2023-01-30,123,482,45,527,85.18,16
Horny Warp,2023-02-17,218,210,14,224,85.18,10
Corsair`s Madness Prologue: Jungle`s Island,2023-02-03,46,69,1,70,85.11,0
Backfirewall_,2023-01-30,86,178,11,189,85.08,2
Troublemaker,2023-03-31,374,458,43,501,85.05,43
Zup! Q,2023-03-08,33,68,1,69,85.04,0
Witch's Garden,2023-04-07,117,68,1,69,85.04,79
Drawing From Memory,2023-02-08,134,147,8,155,85.03,0
FATAL FRAME / PROJECT ZERO: Mask of the Lunar Eclipse,2023-03-09,1372,734,79,813,84.93,90
Temple Of Snek,2023-02-15,21,134,7,141,84.9,0
我在终点线等你,2023-03-24,22,66,1,67,84.89,0
上古传说,2023-04-02,126,219,16,235,84.85,55
9 Childs Street,2023-02-16,30,235,18,253,84.79,9
KOP KILLER 22XX,2023-03-07,6,51,0,51,84.78,0
Souls of White Star,2023-03-30,86,88,3,91,84.73,20
Organs Please,2023-04-05,62,150,9,159,84.72,10
Selene ~Apoptosis~,2023-02-17,704,1527,192,1719,84.71,63
Ash of Gods: The Way Prologue,2023-03-09,747,250,20,270,84.71,5
Zero-G Gunfight,2023-02-17,6,50,0,50,84.69,1
In Sink: A Co-Op Escape Prologue,2023-02-25,1323,1167,142,1309,84.64,219
Tower Escape,2023-02-15,283,213,16,229,84.64,37
ITRP _ Aero Star,2023-03-09,91,75,2,77,84.63,0
Aery - Calm Mind 3,2023-03-31,5,49,0,49,84.6,0
Fateweaver: The Alchemist's Quandary,2023-02-27,8,49,0,49,84.6,0
Tanky Tanks 2,2023-03-20,6,49,0,49,84.6,0
Girl & Gem Magic,2023-03-31,85,211,16,227,84.57,1
Battle Ram,2023-01-06,4403,887,104,991,84.56,7
Relic Dudes,2023-02-03,86,173,12,185,84.49,3
Let's Pet Pets,2023-01-17,12,61,1,62,84.49,0
Final Profit: A Shop RPG,2023-03-06,34,73,2,75,84.48,11
The Farmer Was Replaced,2023-02-10,23,47,0,47,84.41,8
ARK and ADE,2023-03-02,13,72,2,74,84.4,0
Aery VR - A Journey Beyond Time,2023-03-24,4,60,1,61,84.4,0
Gone Rogue,2023-03-01,59,83,3,86,84.39,13
Nebula,2023-01-25,67,82,3,85,84.31,2
Nebula,2023-01-25,67,82,3,85,84.31,0
Nebula,2016-06-02,3,4,0,4,69.2,2
Nebula,2016-06-02,3,4,0,4,69.2,0
The Space-Eating Croc,2023-03-04,12,59,1,60,84.31,0
Super Cakeboy,2023-03-16,23,46,0,46,84.31,2
东方雪莲华 ～ Abyss Soul Lotus.,2023-02-02,290,309,29,338,84.25,6
Crush the Industry,2023-03-31,112,70,2,72,84.24,18
Robo Maestro,2023-01-20,12,58,1,59,84.22,1
Powerful Courses,2023-03-06,7,45,0,45,84.21,0
Cataclysm: Dark Days Ahead,2023-03-31,114,120,7,127,84.16,104
WooLoop,2023-01-13,404,829,101,930,84.14,56
8-Bit Adventures 2,2023-01-31,64,100,5,105,84.13,1
POOSTALL Royale,2023-04-01,164,572,65,637,84.1,1
Deceive Inc.,2023-03-21,2310,1419,190,1609,84.06,"1,351"
Waves of Steel,2023-02-06,112,278,26,304,84.04,4
Methods: The Canada Files,2023-02-01,19,56,1,57,84.03,0
Brave Soldier - Invasion of Cyborgs,2023-02-03,6,43,0,43,84.0,0
Breakers Collection,2023-01-12,78,67,2,69,83.99,0
Loretta,2023-02-16,48,135,9,144,83.97,8
Evacuation,2023-01-06,119,584,68,652,83.95,9
Unbreakable Vr Runner,2023-03-06,5,55,1,56,83.94,0
Terraformers,2023-03-09,1853,1435,195,1630,83.93,420
Vengeful Guardian: Moonrider,2023-01-12,103,226,20,246,83.9,1
江城创业记,2023-03-31,1126,334,34,368,83.88,578
LOUD,2023-02-23,13,42,0,42,83.88,5
Girl Fantasy,2023-02-10,170,385,41,426,83.86,1
Atomic Heart,2023-02-20,38469,17536,2941,20477,83.84,"2,006"
Pocky & Rocky Reshrined,2023-02-24,34,65,2,67,83.81,0
Elle: Portal,2023-02-17,46,114,7,121,83.8,3
STRANGER OF PARADISE FINAL FANTASY ORIGIN,2023-04-06,2544,454,51,505,83.78,"2,259"
Garden in!,2023-01-26,63,131,9,140,83.75,10
Fears to Fathom - Episode 3,2023-01-09,383,627,76,703,83.74,18
Tails: The Backbone Preludes,2023-02-02,55,113,7,120,83.74,3
Breakout 13,2023-01-09,11996,4041,625,4666,83.73,149
PARANOIA PLACE,2023-02-13,68,205,18,223,83.71,17
Half-Life 2: VR Mod - Episode Two,2023-04-06,113,94,5,99,83.71,45
Barbaria,2023-02-09,13,84,4,88,83.69,0
Truxton,2023-02-14,30,40,0,40,83.65,1
Slobbish Dragon Princess 3,2023-03-14,15,40,0,40,83.65,1
Into The Flames,2023-01-10,212,755,97,852,83.55,28
Children of Silentown,2023-01-11,285,365,40,405,83.54,20
Have a Nice Death,2023-03-22,2510,5917,959,6876,83.53,"1,202"
See You Later,2023-02-14,10,51,1,52,83.53,0
Misericorde: Volume One,2023-03-24,17,39,0,39,83.53,0
Miniland Adventure: Prologue,2023-03-13,525,303,32,335,83.43,21
Future Radio,2023-02-17,97,142,11,153,83.41,2
Conjury Revell,2023-02-07,25,125,9,134,83.4,0
Rising Front,2023-01-14,663,860,115,975,83.39,36
West Hunt,2023-03-23,449,662,85,747,83.35,78
Zombie Admin,2023-01-13,8,49,1,50,83.3,1
My Girlfriend’s Special Place,2023-03-13,15,49,1,50,83.3,1
A War of a Madman's Making,2023-01-15,10,37,0,37,83.27,0
Helpless,2023-03-10,34,88,5,93,83.26,3
Siege of Dungeon,2023-01-12,95,155,13,168,83.24,12
GunSuit Guardians,2023-03-31,85,59,2,61,83.23,25
Diary of Lucie,2023-02-24,156,296,32,328,83.21,22
MINDHACK,2023-04-05,195,48,1,49,83.19,36
Phantom Tentacle,2023-03-31,19,337,38,375,83.18,1
TitTok Kitty,2023-02-14,6,36,0,36,83.14,0
Ghostland Yard,2023-03-28,16,36,0,36,83.14,2
Interior Worlds,2023-04-07,35,36,0,36,83.14,9
I commissioned some bunnies,2023-01-26,11,36,0,36,83.14,1
Life After Magic,2023-03-23,16,36,0,36,83.14,1
Flashback,2023-02-20,119,153,13,166,83.13,7
Flashback,2023-02-20,119,153,13,166,83.13,14
Flashback,2023-02-20,119,153,13,166,83.13,0
Flashback,2019-02-28,41,326,77,403,75.82,7
Flashback,2019-02-28,41,326,77,403,75.82,14
Flashback,2019-02-28,41,326,77,403,75.82,0
Flashback,2013-10-01,236,275,200,475,56.66,7
Flashback,2013-10-01,236,275,200,475,56.66,14
Flashback,2013-10-01,236,275,200,475,56.66,0
銀斧 The Honest Elf,2023-03-05,17,58,2,60,83.13,1
Swords and Sandals Immortals,2023-03-09,326,652,86,738,83.1,36
Ogu and the Secret Forest,2023-03-24,235,120,9,129,83.08,34
Neptunia: Sisters VS Sisters,2023-01-24,417,374,44,418,83.06,17
The Missing Parts of Maria Gwozdek,2023-02-10,12,57,2,59,83.02,0
LoFi Hotel,2023-02-04,6,35,0,35,83.0,0
Physical Layer,2023-03-16,43,35,0,35,83.0,1
Broken Universe - Tower Defense,2023-02-05,387,210,21,231,82.97,14
Dread Templar,2023-01-26,159,837,117,954,82.95,8
YOLKED,2023-04-06,8,46,1,47,82.95,0
Veil of Dust: A Homesteading Game,2023-04-02,14,46,1,47,82.95,0
DESTRUCTURE: Among Debris,2023-02-27,15,46,1,47,82.95,3
Rich Lady's Slave Role Play,2023-03-16,68,75,4,79,82.92,5
Absinthia,2023-03-13,12,34,0,34,82.85,1
XXX_CYBERRAT_XXX,2023-02-20,37,74,4,78,82.83,4
Netherguild,2023-03-27,21,45,1,46,82.82,1
Yggdra Union,2023-02-07,118,91,6,97,82.79,10
Song Of The Prairie,2023-04-07,927,154,14,168,82.77,567
大侠立志传,2023-03-08,28936,5218,898,6116,82.76,"4,563"
HITLER: BDSM BUNKER,2023-02-11,403,90,6,96,82.71,1
Finnish Army Simulator,2023-01-13,456,287,33,320,82.7,12
DARK NIGHT WITH FLOPPA,2023-01-06,12,239,26,265,82.7,0
Stuffo the Puzzle Bot,2023-03-02,9,33,0,33,82.7,1
Low Oxygen,2023-03-16,46,63,3,66,82.63,5
WW2 Rebuilder,2023-01-16,1219,608,84,692,82.58,29
Alien maze,2023-02-10,20,143,13,156,82.57,0
枪神出击,2023-01-30,490,43,1,44,82.55,4
Awakened Evil,2023-01-30,6,32,0,32,82.55,0
The Pyramid Of Bones,2023-02-14,16,32,0,32,82.55,0
乱世无双,2023-03-08,24,71,4,75,82.54,5
Full Metal Sergeant,2023-04-03,151,52,2,54,82.44,13
Spiritfall,2023-04-03,587,259,30,289,82.43,85
Berry People,2023-02-14,11,61,3,64,82.42,0
Mage Kanade's Futanari Dungeon Quest,2023-03-14,152,140,13,153,82.39,14
Limbus Company,2023-02-26,30225,7546,1376,8922,82.34,"8,114"
Beer Factory - Prologue,2023-03-13,1279,665,96,761,82.31,61
HELLCARD: Prologue,2023-01-30,482,282,34,316,82.31,17
Dear Monster,2023-01-17,102,51,2,53,82.31,1
Bumblebee - Little Bee Adventure,2023-02-10,6,51,2,53,82.31,0
Scorchlands,2023-02-07,24,41,1,42,82.27,1
Eggcelerate! to the Tropics,2023-03-30,15,41,1,42,82.27,0
Tell Some Story: Foz,2023-02-02,9,30,0,30,82.22,0
Gore Storm,2023-03-10,15,30,0,30,82.22,0
TerraScape,2023-04-05,353,137,13,150,82.21,122
TET,2023-01-31,5,59,3,62,82.19,0
Unholy Angel,2023-01-16,11,50,2,52,82.19,0
Pets Hotel: Prologue,2023-01-25,197,239,28,267,82.17,13
Brave's Rage,2023-02-01,160,205,23,228,82.14,10
Missing Hiker,2023-02-14,169,954,148,1102,82.13,10
NSFW Solitaire,2023-01-27,70,114,10,124,82.13,44
Yihongyuan,2023-03-02,416,496,70,566,82.05,12
Akka Arrh,2023-02-21,15,29,0,29,82.04,0
Rustled Pete,2023-02-28,8,29,0,29,82.04,0
ToriDori,2023-04-06,13,29,0,29,82.04,2
柒愿传说,2023-04-01,8,29,0,29,82.04,0
天外武林 (Traveler of Wuxia),2023-01-06,5874,2093,359,2452,81.99,196
The Sea-demon,2023-01-06,75,168,18,186,81.97,1
Catch Me!,2023-01-24,24,39,1,40,81.97,0
ハッピーライヴ ショウアップ！,2023-03-10,23,39,1,40,81.97,3
The Secret of Darkwoods,2023-03-28,21,39,1,40,81.97,2
Sunrider 4: The Captain's Return,2023-02-08,199,126,12,138,81.95,14
Treason,2023-01-31,226,383,52,435,81.94,16
The Black Grimoire: Cursebreaker,2023-03-10,137,89,7,96,81.93,3
inhabit,2023-01-27,7,28,0,28,81.86,0
DEFECTIVE,2023-02-03,4,28,0,28,81.86,1
DEFECTIVE,2023-02-03,4,28,0,28,81.86,0
DEFECTIVE,2017-09-05,3,20,29,49,43.64,1
DEFECTIVE,2017-09-05,3,20,29,49,43.64,0
Tactical Command,2023-01-27,11,28,0,28,81.86,0
Jury,2023-04-02,60,28,0,28,81.86,17
Dusk of the Cage,2023-02-21,7,28,0,28,81.86,0
Smalland: Survive the Wilds,2023-03-29,12741,2200,384,2584,81.84,"3,103"
Sons Of The Forest,2023-02-23,414257,99696,20716,120412,81.83,"20,709"
Outlanders,2023-03-07,147,95,8,103,81.8,63
Wretched Depths,2023-03-24,20,64,4,68,81.78,3
File Destined,2023-02-25,32,171,19,190,81.77,3
HELLCARD,2023-02-16,3539,916,147,1063,81.73,503
Reshaping Mars,2023-03-30,642,568,85,653,81.73,337
你农我农-Need Know What Know,2023-02-05,84,94,8,102,81.71,4
Lunar Mirror:The Pavilion of Desire,2023-03-04,1331,605,92,697,81.67,52
One Night At Barneys 3,2023-01-05,24,86,7,93,81.66,0
Joshua's Legs,2023-01-18,5,27,0,27,81.66,0
QUALIA ~The Path of Promise~,2023-02-03,12,27,0,27,81.66,0
Joe Wander,2023-02-03,12,27,0,27,81.66,2
不可思异世界,2023-01-17,10,27,0,27,81.66,0
Luckily My Arm Is A Shotgun,2023-02-22,3,27,0,27,81.66,0
Hydrofoil Generation,2023-02-16,39,37,1,38,81.65,3
Ballistic Zen,2023-01-25,9,37,1,38,81.65,0
Wall World,2023-04-05,4403,924,150,1074,81.63,"4,006"
Wander Hero,2023-01-12,851,499,74,573,81.61,74
Terra Nil,2023-03-28,5916,1732,305,2037,81.49,687
UnderDungeon,2023-01-13,7,45,2,47,81.48,0
Forrader Hero,2023-01-23,28,45,2,47,81.48,0
Forest Of Relics,2023-01-25,10,45,2,47,81.48,1
Helvetii,2023-02-03,21,36,1,37,81.47,0
Deadnaut: Signal Lost,2023-03-28,56,36,1,37,81.47,4
Mythargia,2023-02-20,7,26,0,26,81.46,0
FUR Squadron,2023-03-16,5,26,0,26,81.46,0
Iron Mandate,2023-03-11,42,69,5,74,81.45,11
Dice Kingdoms,2023-04-03,110,53,3,56,81.42,32
Ancient Saga: Vikings Journey - Resource Management Simulator,2023-03-10,20,53,3,56,81.42,2
Puppet Master: The Game,2023-03-01,249,293,40,333,81.38,16
SpaceBourne 2,2023-02-17,1241,1384,241,1625,81.37,740
The Wreck,2023-03-14,20,68,5,73,81.34,2
Paperback Adventures,2023-01-30,22,44,2,46,81.33,2
Digimon World: Next Order,2023-02-21,1685,429,64,493,81.3,192
World Of Mystery,2023-01-08,362,117,12,129,81.3,12
Toy Tactics,2023-03-17,12,35,1,36,81.3,0
Star Ring,2023-01-20,38,52,3,55,81.29,2
山海灵妖录,2023-03-03,362,434,65,499,81.28,119
Tactical Assault VR,2023-03-27,185,278,38,316,81.27,53
The Director's Disorder: Pilot Episode,2023-01-19,57,162,19,181,81.26,0
Agent in Depth,2023-01-20,20,103,10,113,81.26,0
Buildest,2023-03-24,10,25,0,25,81.25,0
BLACK★ACADEMY,2023-03-17,11,25,0,25,81.25,1
No:Worse,2023-03-16,6,25,0,25,81.25,0
Konkan Coast Pirate Solutions,2023-03-01,6,25,0,25,81.25,1
I commissioned some cats,2023-02-16,11,25,0,25,81.25,2
September 7th,2023-01-06,149,808,134,942,81.22,15
Magic Research,2023-03-23,1109,59,4,63,81.17,785
Shiner,2023-03-18,28,59,4,63,81.17,3
Nienix,2023-03-24,352,179,22,201,81.15,55
2112TD: Tower Defense Survival,2023-01-19,332,172,21,193,81.11,27
Lost Cartridge - Cold Read,2023-12-31,15,34,1,35,81.11,0
Zedfest,2023-04-07,19,159,19,178,81.07,5
Hero's Quest: Automatic Roguelite RPG,2023-03-16,137,80,7,87,81.05,38
Belle Automata,2023-03-03,13,24,0,24,81.03,0
Takara Cards,2023-03-28,5,24,0,24,81.03,0
Chief Emoji Officer,2023-04-07,7,24,0,24,81.03,0
Pipe Dreams,2023-03-31,5,24,0,24,81.03,0
Citizens: Far Lands - Prologue,2023-03-07,145,100,10,110,81.0,3
SATUS,2023-02-10,13,42,2,44,81.0,0
Like a Dragon: Ishin!,2023-02-21,8461,2315,437,2752,80.98,698
Spectator,2023-02-07,16,65,5,70,80.98,3
The Wall Mustn't Fall,2023-01-09,43,33,1,34,80.92,2
The Voidness - LIDAR Horror Survival Game,2023-04-07,23,33,1,34,80.92,4
Bad cat Sam,2023-01-25,12,57,4,61,80.9,0
Lucie Adult Game HD,2023-01-10,120,92,9,101,80.88,12
X Invader: Prologue,2023-02-01,549,451,71,522,80.87,28
United heist,2023-02-12,335,732,124,856,80.86,22
Monster Girl 1000,2023-04-02,416,49,3,52,80.84,209
Under Maintenance,2023-02-14,34,41,2,43,80.83,3
Labyrinth of Galleria: The Moon Society,2023-02-14,859,197,26,223,80.82,119
Sakura Succubus 7,2023-03-06,22,23,0,23,80.79,1
Speedonauts,2023-02-21,5,23,0,23,80.79,0
Gum Ball Run,2023-01-09,206,440,70,510,80.72,13
Lovely Crush,2023-04-10,15,32,1,33,80.72,0
The Test: Secrets of the Soul 2,2023-04-10,9,32,1,33,80.72,0
Warman,2023-04-03,26,48,3,51,80.69,7
Sorry We're Open,2023-02-18,19,40,2,42,80.66,1
Athenian Rhapsody: Thunder Goober's Personality Dungeon,2023-03-23,13,40,2,42,80.66,3
Earth's Shadow,2023-01-31,15,69,6,75,80.6,1
Cold Shell,2023-02-28,5,22,0,22,80.54,2
Oedo Trigger!!,2023-01-13,29,22,0,22,80.54,3
TeamPunk,2023-01-20,8,22,0,22,80.54,0
Museum of Monoliths,2023-02-28,3,22,0,22,80.54,0
Apex Armor Swap Trainer,2023-04-07,15,22,0,22,80.54,3
I Won't Forget Hue,2023-01-20,32,120,14,134,80.52,0
Squirrel Launcher,2023-01-31,32,120,14,134,80.52,2
HYPERBLADE,2023-02-01,9,31,1,32,80.51,0
Deflector,2023-03-24,629,225,32,257,80.49,10
Family curse,2023-03-31,23,39,2,41,80.48,4
Horde Hunters,2023-02-16,47,39,2,41,80.48,3
Bone Dust,2023-02-21,13,54,4,58,80.47,0
LUNARK,2023-03-30,57,94,10,104,80.44,12
Undead Horde 2: Necropolis,2023-03-30,839,177,24,201,80.36,77
The Beast In The Cave,2023-02-07,21,46,3,49,80.36,0
The Fernweh Saga: Book One,2023-01-05,114,67,6,73,80.34,1
Nope Nope Nope Nurses,2023-01-20,20,53,4,57,80.32,3
bearcycle,2023-03-03,11,30,1,31,80.3,2
Wet Sand,2023-01-06,9,30,1,31,80.3,1
Keep the Keep,2023-03-15,4,21,0,21,80.28,0
First Racer,2023-04-05,10,21,0,21,80.28,0
Super Greedy Cat,2023-03-29,4,21,0,21,80.28,0
Endless Nesla,2023-01-24,4,21,0,21,80.28,0
메스가키 영애님!,2023-01-20,22,66,6,72,80.21,2
远征三国-策略卡牌,2023-02-17,49,104,12,116,80.2,5
The Simulacrum,2023-01-17,16,45,3,48,80.19,0
Germinal,2023-03-09,10,37,2,39,80.09,2
Offroad Mechanic Simulator: Prologue - First Job,2023-04-03,58,37,2,39,80.09,21
三国真龙传,2023-02-13,12,37,2,39,80.09,5
GunSoul Girl 2,2023-03-30,180,370,61,431,80.08,28
Research Story,2023-02-21,96,65,6,71,80.08,10
Hellscreen,2023-03-09,7,29,1,30,80.07,0
Conur Life,2023-03-06,7,29,1,30,80.07,0
A TAVERN FOR TEA,2023-03-24,8,29,1,30,80.07,2
Verlet Ascend,2023-02-28,20,58,5,63,80.04,0
Land of the Mage Lords,2023-01-29,18,51,4,55,80.01,0
Joon Shining,2023-02-17,3,20,0,20,80.0,0
Elohim Eternal: The Babel Code,2023-01-30,9,20,0,20,80.0,1
Heartwood Heroes,2023-03-27,43,20,0,20,80.0,4
The Overlord Isn't Another Isekai Protagonist Is He?,2023-02-17,8,20,0,20,80.0,4
奇谭文字游戏,2023-02-09,9,20,0,20,80.0,0
SokoChess White,2023-03-03,8,20,0,20,80.0,0
Shooting Saucer,2023-04-06,11,20,0,20,80.0,0
Hood Warfare,2023-01-26,25,64,6,70,79.95,1
Dark Chess,2023-02-28,27,101,12,113,79.92,2
Socrates Jones: Pro Philosopher,2023-03-28,15,36,2,38,79.89,1
Striving for Light: Survival,2023-02-20,55,50,4,54,79.84,10
BDSM Love,2023-01-06,10,43,3,46,79.83,0
Finding Xavier,2023-01-20,5,43,3,46,79.83,0
Snafu,2023-03-08,11,43,3,46,79.83,0
WHALIEN - Unexpected Guests,2023-01-24,9,28,1,29,79.83,0
Re:Call,2023-01-17,13,28,1,29,79.83,0
Fairy Biography3 : Obsession,2023-03-24,166,167,24,191,79.74,8
《奇门遁甲》,2023-01-01,137,172,25,197,79.72,4
The Legend of Heroes: Kuro no Kiseki Ⅱ -CRIMSON SiN-,2023-01-25,1071,313,52,365,79.71,162
Drakkar Crew,2023-03-27,9,19,0,19,79.71,1
Asfalia,2023-01-23,5,19,0,19,79.71,0
Mega Mall Story 2,2023-03-06,67,19,0,19,79.71,9
Linked Worlds,2023-03-29,10,19,0,19,79.71,0
FAKE HEART,2023-03-25,9,19,0,19,79.71,0
Memory Traces: Egypt,2023-02-17,6,19,0,19,79.71,0
Brick Odyssey,2023-01-25,14,19,0,19,79.71,5
Wind Up,2023-01-12,27,19,0,19,79.71,0
Logic - Keypad,2023-03-10,3,19,0,19,79.71,0
Ashes of War,2023-01-27,6,19,0,19,79.71,1
Endless Dark,2023-02-22,6,19,0,19,79.71,0
TRAUMA Broken Paradise,2023-03-03,4,19,0,19,79.71,0
降妖散记,2023-04-03,883,272,44,316,79.7,383
District Steel,2023-02-16,8,35,2,37,79.68,0
No Questions Asked,2023-01-09,4,35,2,37,79.68,0
幻斋阴阳录 Genzai:Serialization,2023-01-20,45,110,14,124,79.66,0
Mr. Hopp's Playhouse 3,2023-03-17,38,42,3,45,79.65,3
Tokyo Necro,2023-03-13,76,68,7,75,79.62,8
Spellmasons,2023-01-31,127,92,11,103,79.61,6
The Tales of Bayun,2023-02-16,41,86,10,96,79.6,0
Story of Animal Sprite,2023-04-07,26,27,1,28,79.58,23
Black Reliquary,2023-03-24,542,247,40,287,79.51,515
Within The Backrooms,2023-01-13,9,34,2,36,79.46,1
Potion Brew: Co-op,2023-01-05,14,34,2,36,79.46,0
Webcam Sex,2023-01-20,9,34,2,36,79.46,0
Drop - System Breach,2023-03-28,54,41,3,44,79.45,7
Chef Life: A Restaurant Simulator,2023-02-23,840,476,87,563,79.42,227
Painting Werther,2023-02-14,4,18,0,18,79.39,0
Palette Swap,2023-01-21,4,18,0,18,79.39,0
Bullet Casters,2023-03-28,8,18,0,18,79.39,0
За Закатом Неминуем Рассвет,2023-03-31,6,18,0,18,79.39,1
Kairobotica,2023-01-16,21,18,0,18,79.39,1
Zellige: The Tilemaker of Granada,2023-02-17,4,18,0,18,79.39,1
FFF,2023-02-14,6,18,0,18,79.39,0
Project Malice,2023-01-20,12,18,0,18,79.39,0
呆呆大冒险,2023-02-22,20,18,0,18,79.39,4
UnknownPyramid,2023-02-22,36,18,0,18,79.39,5
ZaBaTa!,2023-03-28,19,18,0,18,79.39,1
100 Keys To Your Heart,2023-01-16,3,18,0,18,79.39,0
Hope,2023-01-27,3,18,0,18,79.39,0
Hope,2023-01-27,3,18,0,18,79.39,0
Hope,2020-08-07,2,3,2,5,54.17,0
Hope,2020-08-07,2,3,2,5,54.17,0
Pretend Cars Racing,2023-03-08,4,18,0,18,79.39,0
Side Scape,2023-01-27,4,18,0,18,79.39,0
The Castle Burns!,2023-03-03,6,18,0,18,79.39,0
Yukiiro Sign,2023-03-24,11,18,0,18,79.39,2
Vernal Edge,2023-03-14,208,249,41,290,79.36,19
Locked In Mind,2023-01-04,82,244,40,284,79.36,5
SGS Taipings,2023-01-19,89,101,13,114,79.34,6
Belial Red,2023-03-11,218,47,4,51,79.32,4
Project Astra Dominium,2023-03-29,12,26,1,27,79.32,5
三國立志傳,2023-01-10,36,26,1,27,79.32,2
The Adventures of LinShanHai,2023-02-01,13,26,1,27,79.32,0
Chaos Galaxy 2,2023-01-06,107,171,26,197,79.31,11
GRANDMA,2023-01-07,30,170,26,196,79.25,0
Tropicalia,2023-02-28,14,53,5,58,79.25,0
AlexanderBall: A Countryball Tale,2023-01-20,23,40,3,43,79.25,4
Voltaire - The Vegan Vampire,2023-02-27,49,59,6,65,79.22,2
Territory: Farming and Fighting,2023-01-12,122,153,23,176,79.16,10
Redtape,2023-02-14,11,46,4,50,79.14,3
Barista Simulator,2023-01-12,78,136,20,156,79.06,12
Minigame Game,2023-02-03,8,17,0,17,79.05,0
We Are Screwed!,2023-03-01,17,17,0,17,79.05,0
Magirune 2,2023-01-11,12,17,0,17,79.05,0
Temple of Starlight,2023-01-24,6,17,0,17,79.05,0
Infested Fortress,2023-03-02,17,17,0,17,79.05,3
Burg Wimmel,2023-03-06,5,17,0,17,79.05,0
CucumbeRunner,2023-03-06,9,17,0,17,79.05,0
Ibis AM,2023-02-17,5,17,0,17,79.05,0
Frack the World,2023-03-01,8,17,0,17,79.05,0
Beep's Escape,2023-02-16,5,17,0,17,79.05,0
Spirit of Midnight: Prologue,2023-02-09,4,17,0,17,79.05,0
Sagres,2023-04-03,145,39,3,42,79.04,37
IDEA,2023-03-09,3,25,1,26,79.04,0
Hentai EroCum,2023-02-24,5,25,1,26,79.04,1
CosmoOdyssey 2: Comeback to origin,2023-02-17,3,25,1,26,79.04,1
Meet Your Maker,2023-04-04,3308,1186,249,1435,78.99,"1,684"
Attic Panic,2023-03-29,19,32,2,34,78.99,0
Doomsday Robot Girl,2023-01-10,129,135,20,155,78.98,3
Tanks in Labyrinth,2023-02-03,40,75,9,84,78.97,3
METAL DOGS,2023-03-24,924,578,113,691,78.95,8
Castle Warriors,2023-02-23,45,45,4,49,78.95,2
Elderand,2023-02-16,203,210,35,245,78.91,16
Combat Mission: Battle for Normandy,2023-03-28,104,51,5,56,78.91,43
Drain Mansion,2023-03-09,167,80,10,90,78.89,4
捉妖物语2,2023-01-18,499,836,172,1008,78.83,55
Furry Sex 2,2023-01-13,8,38,3,41,78.83,0
CUBEMATRIX,2023-01-27,24,96,13,109,78.82,1
Arrogation: Unlight of Day,2023-01-28,43,223,38,261,78.81,2
One Military Camp,2023-03-02,822,183,30,213,78.77,61
Forest Fire,2023-01-10,22,44,4,48,78.75,1
林中人,2023-01-29,9,44,4,48,78.75,0
1997,2023-03-30,13,24,1,25,78.75,5
Rabat Protocol:Metal Rhapsody,2023-03-25,13,24,1,25,78.75,0
Inkulinati,2023-01-31,240,132,20,152,78.74,6
The Survival of Sarah Rose,2023-01-19,24,31,2,33,78.74,6
Gladiators and Glory,2023-03-03,14,31,2,33,78.74,0
Colossal Cave,2023-01-19,35,50,5,55,78.73,4
Atrio: The Dark Wild,2023-01-10,455,330,61,391,78.7,11
Tebb,2023-02-01,3,16,0,16,78.69,0
ShemHaMephorash,2023-03-29,8,16,0,16,78.69,1
Human or Not,2023-01-20,9,16,0,16,78.69,0
HIGhSCORE,2023-03-09,8,16,0,16,78.69,0
GUN KING,2023-03-03,5,16,0,16,78.69,0
The Legend of Gwen,2023-02-16,4,16,0,16,78.69,0
Trouble in Tornado Town,2023-01-06,3,16,0,16,78.69,0
Kill Your Shapes,2023-03-31,5,16,0,16,78.69,0
GachaHell,2023-04-07,7,16,0,16,78.69,0
Returnal™,2023-02-15,6691,3424,793,4217,78.67,430
Daydream: Prologue,2023-03-03,722,306,56,362,78.67,9
My dream setup,2023-02-20,497,575,116,691,78.57,69
Saint Maker,2023-02-22,40,72,9,81,78.57,4
Escape First Alchemist,2023-03-02,161,155,25,180,78.56,4
Artificiality-人造物-,2023-02-25,28,30,2,32,78.48,0
Flame Keeper,2023-03-17,20,30,2,32,78.48,0
Elfheim - Chapter 1,2023-12-31,19,30,2,32,78.48,0
Hentai Fox,2023-02-03,7,30,2,32,78.48,0
Rogue AI Simulator,2023-01-12,264,212,37,249,78.47,21
ONE PIECE ODYSSEY,2023-01-12,7545,1589,356,1945,78.45,183
Alephant,2023-03-01,14,23,1,24,78.44,3
Madorica Real Estate 2 - The mystery of the new property -,2023-02-08,12,23,1,24,78.44,0
Guardians Frontline,2023-03-09,35,113,17,130,78.41,5
Death in the Water 2,2023-01-26,344,541,110,651,78.4,6
Ogre Chambers DX,2023-03-03,39,54,6,60,78.4,2
The Exсrawlers,2023-02-27,15,36,3,39,78.37,2
EXS2～EthnologySister2：Structuralism of kinship system,2023-01-20,11,36,3,39,78.37,0
UC Love,2023-03-01,14,36,3,39,78.37,0
丸转三国,2023-01-07,23,48,5,53,78.36,0
Life Gallery,2023-01-12,49,142,23,165,78.32,0
All-In-One Sports VR,2023-04-07,51,383,75,458,78.31,39
Return to abyss 重返深渊,2023-01-06,2066,585,121,706,78.3,68
One Giant Leap,2023-01-08,4,15,0,15,78.3,0
Checkmate Kings,2023-01-30,5,15,0,15,78.3,0
Operator8,2023-03-31,3,15,0,15,78.3,0
BETA-SIXDOUZE,2023-02-10,4,15,0,15,78.3,0
RUSHAWAY,2023-02-23,6,15,0,15,78.3,1
超级破碎球,2023-03-11,3,15,0,15,78.3,0
The secret pyramid VR,2023-01-18,4,15,0,15,78.3,0
Super Video Golf,2023-02-02,6,15,0,15,78.3,0
COSMIC HOLES,2023-03-13,3,15,0,15,78.3,0
Anime RPG: Isekai Journey,2023-03-10,6,15,0,15,78.3,0
可识此阵,2023-01-25,6,15,0,15,78.3,0
Finger Football: Goal in One,2023-02-24,2,15,0,15,78.3,0
Jigsaw Puzzle Delicious Foods,2023-03-09,4,15,0,15,78.3,1
Vampire Story,2023-03-24,7,15,0,15,78.3,0
9 Years of Shadows,2023-03-27,316,517,106,623,78.23,58
Apocalyptic Vibes,2023-03-02,37,75,10,85,78.23,1
Innchanted,2023-03-28,133,53,6,59,78.22,21
Schildmaid MX,2023-03-24,15,29,2,31,78.21,0
Dream Bright,2023-02-21,14,29,2,31,78.21,1
BACKROOMS: APPREHENSION,2023-01-31,242,85,12,97,78.16,10
Whackerball,2023-01-30,17,41,4,45,78.13,0
Interstellar Pilot 2,2023-01-02,25,35,3,38,78.13,6
Isle of Pan,2023-01-10,6,22,1,23,78.11,0
Relic Space,2023-03-09,23,22,1,23,78.11,0
COTTOn Rock'n'Roll,2023-01-06,22,22,1,23,78.11,1
The Safe Place,2023-03-22,9,22,1,23,78.11,1
Otome Legends,2023-02-08,5,22,1,23,78.11,1
Alice Escaped!,2023-01-27,145,134,22,156,78.06,1
Gachi: Christmas Party 🎄,2023-01-07,36,68,9,77,77.99,0
Rough Justice: '84,2023-03-13,34,46,5,51,77.96,2
Aashaa,2023-01-27,8,46,5,51,77.96,1
Burger Bistro Story,2023-01-16,133,57,7,64,77.94,25
Supplice,2023-04-06,112,118,19,137,77.93,39
时灵：星辰愚者,2023-02-14,55,78,11,89,77.93,2
Graveyard Architect,2023-02-23,6,28,2,30,77.92,0
MeiQi 2023,2023-02-20,17,28,2,30,77.92,1
Undead World,2023-03-10,25,28,2,30,77.92,3
The You Testament 2D,2023-02-01,10,28,2,30,77.92,0
yni^,2023-02-28,4,28,2,30,77.92,0
Beyond the Wall,2023-03-21,6,28,2,30,77.92,2
Beyond the Wall,2023-03-21,6,28,2,30,77.92,0
Beyond the Wall,2023-03-21,6,28,2,30,77.92,0
Beyond the Wall,2017-10-24,5,39,16,55,64.68,2
Beyond the Wall,2017-10-24,5,39,16,55,64.68,0
Beyond the Wall,2017-10-24,5,39,16,55,64.68,0
Beyond the Wall,2017-08-08,4,6,9,15,44.34,2
Beyond the Wall,2017-08-08,4,6,9,15,44.34,0
Beyond the Wall,2017-08-08,4,6,9,15,44.34,0
You are the weapon,2023-01-03,9,93,14,107,77.9,0
Sexy Milfs,2023-01-27,9,34,3,37,77.88,1
Helmetman,2023-03-13,19,34,3,37,77.88,2
Cyber Cult City,2023-03-28,3,14,0,14,77.87,0
天地情殇,2023-02-28,12,14,0,14,77.87,0
Strange Town,2023-03-24,10,14,0,14,77.87,0
The Pyraplex,2023-02-13,26,14,0,14,77.87,3
Unforgettable Voyage,2023-03-01,4,14,0,14,77.87,0
The Senex Bird,2023-02-22,4,14,0,14,77.87,0
Ruined Kingdom,2023-03-01,4,14,0,14,77.87,1
Flower Memories,2023-02-01,3,14,0,14,77.87,0
Sky Strikers VR,2023-03-05,15,14,0,14,77.87,0
The militant mouse,2023-01-13,4,14,0,14,77.87,0
Crawlspace 2,2023-01-18,4,14,0,14,77.87,0
The King of Cats,2023-02-16,5,14,0,14,77.87,0
炸弹魔塔 Bomb Tower,2023-03-09,3,14,0,14,77.87,0
Lawnmower Game: Find Trump,2023-02-03,3,14,0,14,77.87,0
TrashMorfers,2023-03-16,2,14,0,14,77.87,0
Words of Wisdom,2023-03-21,3,14,0,14,77.87,0
Rabbi-T,2023-03-07,3,14,0,14,77.87,0
Animalistic,2023-03-01,5,51,6,57,77.85,0
Alien Slayers,2023-02-01,47,51,6,57,77.85,1
DUCK: Dangerous Ultimate Cartridge Kidnapper,2023-02-14,18,67,9,76,77.84,1
Clunky Hero,2023-01-25,19,72,10,82,77.81,3
Kill Pill,2023-01-14,18,56,7,63,77.77,0
Refund Me If You Can : Lexy's Story,2023-02-24,4,21,1,22,77.77,0
The Legend of Heroes: Kuro no Kiseki,2023-03-02,139,21,1,22,77.77,43
The Legend of Heroes: Kuro no Kiseki,2023-03-02,139,21,1,22,77.77,199
The Legend of Heroes: Kuro no Kiseki,2022-07-27,2120,976,70,1046,87.97,43
The Legend of Heroes: Kuro no Kiseki,2022-07-27,2120,976,70,1046,87.97,199
Meme Quiz,2023-02-13,5,21,1,22,77.77,0
2022生存指南 2022 SURVIVAL GUIDE,2023-03-14,5,21,1,22,77.77,0
Gummy Dummy Battles,2023-01-24,8,21,1,22,77.77,0
ATONE: Heart of the Elder Tree,2023-01-27,12,45,5,50,77.75,0
Ten Dates,2023-02-14,198,186,34,220,77.74,3
GROSS,2023-01-11,99,106,17,123,77.7,1
Ghosts Of Tabor,2023-03-21,1000,1144,265,1409,77.68,543
Spelp,2023-01-31,223,39,4,43,77.67,0
Path of the Midnight Sun,2023-01-10,111,86,13,99,77.65,4
Spikair Volleyball,2023-02-06,18,33,3,36,77.62,0
Protect Harem City,2023-02-15,35,33,3,36,77.62,2
Presentiment of Death,2023-03-01,5,27,2,29,77.62,0
Taco Carlos,2023-01-09,11,27,2,29,77.62,0
Senpai Puzzle: Waifu Summer,2023-02-27,6,27,2,29,77.62,1
Arena Renovation,2023-03-27,306,80,12,92,77.51,31
Crimson Dawn,2023-04-11,132,191,36,227,77.48,17
Lunar Mirror,2023-01-19,588,623,139,762,77.45,8
Parasomnia,2023-02-18,5,49,6,55,77.45,0
Gachi: Space Orgasm,2023-01-09,84,94,15,109,77.44,2
Now There Be Goblins,2023-04-04,8,38,4,42,77.43,0
Mythlink,2023-01-20,2,13,0,13,77.41,0
Adventures of The Carrot Captain,2023-04-04,7,13,0,13,77.41,0
GRAPPIN,2023-03-24,6,13,0,13,77.41,0
Kitten Hero,2023-02-01,3,13,0,13,77.41,1
Stars Arisen,2023-03-15,52,13,0,13,77.41,3
Super Ninja Miner,2023-03-08,2,13,0,13,77.41,0
Frame - Portals on Steroids,2023-01-12,8,13,0,13,77.41,0
Carnival of Gods: Oppression,2023-02-21,3,13,0,13,77.41,0
Red List Girls.-Andean Flamingo-,2023-02-23,4,13,0,13,77.41,0
Forklift Extreme,2023-03-16,12,13,0,13,77.41,1
Starway: BaRaider,2023-02-16,4,13,0,13,77.41,0
Tower Skydiver,2023-02-15,3,13,0,13,77.41,0
Frogurai,2023-03-10,4,13,0,13,77.41,0
Web or Dead,2023-02-16,4,13,0,13,77.41,0
Wild Seas,2023-02-05,4,13,0,13,77.41,0
Unusual Ghost,2023-01-27,3,13,0,13,77.41,0
First Person Hooper,2023-02-28,3,13,0,13,77.41,1
The House of E.,2023-03-23,5,13,0,13,77.41,0
River Tails: Stronger Together,2023-03-16,9,20,1,21,77.4,2
Public Land Hunter,2023-02-28,8,20,1,21,77.4,0
Well...,2023-04-01,10,20,1,21,77.4,0
Hentai Journey,2023-03-24,7,20,1,21,77.4,0
Eternal Dread 3,2023-03-10,378,126,22,148,77.34,42
Blockworks,2023-01-07,9,32,3,35,77.34,0
Makis Adventure,2023-01-18,16,32,3,35,77.34,1
Out Zone,2023-02-14,13,32,3,35,77.34,2
Alkurai,2023-03-09,24,32,3,35,77.34,1
Card Crawl Adventure,2023-03-01,21,32,3,35,77.34,5
異境迷走,2023-03-23,37,32,3,35,77.34,5
中华一商,2023-02-23,1137,397,85,482,77.33,77
Nucleares,2023-03-13,33,43,5,48,77.32,7
Rogue Station,2023-01-26,49,43,5,48,77.32,7
Rogue Shift,2023-02-09,11,26,2,28,77.3,0
Kill The Emperor,2023-01-22,5,26,2,28,77.3,0
SHIRIME: The Curse of Butt-Eye,2023-03-31,9,26,2,28,77.3,2
Phantom Brigade,2023-02-28,5671,1627,399,2026,77.24,216
Hot And Lovely ：Charm,2023-02-16,666,405,88,493,77.18,4
Kingdom of EXPLORERS,2023-03-10,19,37,4,41,77.18,1
SpellForce: Conquest of Eo,2023-02-03,3669,1069,256,1325,77.16,338
Soul Wargame,2023-01-11,49,101,17,118,77.15,2
台北大空襲 Raid on Taihoku,2023-02-16,91,119,21,140,77.11,3
三國立志傳2,2023-03-24,130,42,5,47,77.09,33
Mato Anomalies,2023-03-10,49,72,11,83,77.07,6
The Wraith of the Galaxy,2023-02-15,4,31,3,34,77.06,0
Someday You'll Return: Director's Cut,2023-03-07,28,31,3,34,77.06,6
What is snowman made of?,2023-01-17,9,47,6,53,77.04,0
Golgotha,2023-02-21,103,400,88,488,77.01,2
Olgob The Bold,2023-01-20,4,19,1,20,77.0,0
RPG Stories,2023-04-03,11,19,1,20,77.0,5
Rayland 2,2023-03-31,7,19,1,20,77.0,0
Bad Hop Baseball,2023-02-21,6,19,1,20,77.0,0
Volley Pals,2023-04-07,7,25,2,27,76.97,2
Glass Heart,2023-02-03,11,25,2,27,76.97,1
Blue Wednesday: Prologue,2023-03-09,23,25,2,27,76.97,1
OPEN DOOR,2023-02-02,7,36,4,40,76.92,0
Creative Console,2023-01-10,19,36,4,40,76.92,0
Hot Heat Reset: Chapter 1,2023-03-02,42,36,4,40,76.92,2
Don't Byte Your Tongue,2023-04-07,3,12,0,12,76.9,0
Poly Vita,2023-03-01,5,12,0,12,76.9,0
Kit's Quest,2023-01-06,3,12,0,12,76.9,0
Richman 7,2023-03-16,14,12,0,12,76.9,5
Back Rank Chess,2023-02-04,3,12,0,12,76.9,0
Boundary Walls,2023-02-21,7,12,0,12,76.9,0
Feed Him,2023-02-28,3,12,0,12,76.9,0
The Lone Alien,2023-02-17,6,12,0,12,76.9,0
CRAZY GUY,2023-03-20,3,12,0,12,76.9,0
4 Seasons Runner,2023-04-04,4,12,0,12,76.9,2
Bullet Runner: The First Slaughter,2023-03-24,6,12,0,12,76.9,1
Hidden Harbor 3 Top-Down 3D,2023-03-22,2,12,0,12,76.9,0
AColony,2023-01-19,84,61,9,70,76.85,11
A Fox and His Robot,2023-03-01,5,41,5,46,76.85,0
Playcraft,2023-01-17,210,557,129,686,76.83,0
Armoured Cavalry: Operation Valkyrie,2023-01-12,15,30,3,33,76.76,0
The Karaoke | ヒトカラ,2023-02-04,446,296,64,360,76.75,5
Love n War: Hero by Chance II,2023-01-06,368,201,41,242,76.73,5
Lumencraft,2023-02-28,786,671,160,831,76.68,59
Tribe Dash,2023-04-06,25,55,8,63,76.64,5
城市弧光,2023-03-03,6,24,2,26,76.62,0
DEFCON: Xenos,2023-01-12,12,24,2,26,76.62,1
Lucky Goal,2023-01-01,55,24,2,26,76.62,0
Save The Girls,2023-02-14,6,24,2,26,76.62,0
EL NE RUE,2023-01-30,14,24,2,26,76.62,0
Elephantasy: Flipside,2023-02-28,13,24,2,26,76.62,1
Turnament,2023-02-17,3,18,1,19,76.58,0
Unprompted,2023-03-07,3,18,1,19,76.58,1
Dream Fight Will,2023-02-15,7,18,1,19,76.58,0
B-Horror: Subway,2023-03-26,5,18,1,19,76.58,0
风帆纪元 Sailing Era,2023-01-12,8335,2333,613,2946,76.56,408
RUSLICSTAN INVADES,2023-03-17,29,78,13,91,76.56,2
Star Survivor,2023-03-02,237,169,34,203,76.54,83
Dinogen Online,2023-03-04,96,100,18,118,76.5,19
Gal Guardians: Demon Purge,2023-02-23,1348,511,121,632,76.43,25
Gatekeeper: Eclipse,2023-02-27,1133,482,114,596,76.37,30
Pixel Survivors: Roguelike,2023-02-24,169,252,55,307,76.37,11
Roller Drama,2023-01-26,7,11,0,11,76.34,0
Orbital Strike VR,2023-01-31,5,11,0,11,76.34,0
BLOOD RITE,2023-03-23,3,11,0,11,76.34,0
SlipDream Resonator,2023-03-01,4,11,0,11,76.34,0
You Are A Pilot,2023-01-19,4,11,0,11,76.34,0
Gem Worlds,2023-01-16,2,11,0,11,76.34,0
Cosmic Ball Tournament,2023-03-02,2,11,0,11,76.34,0
Poly Skies,2023-01-23,6,11,0,11,76.34,0
Pawsecuted,2023-03-24,5,11,0,11,76.34,0
液化物,2023-03-03,3,11,0,11,76.34,0
Basketball Club Story,2023-04-10,131,11,0,11,76.34,98
EXIT The Game – Trail of the Griffin,2023-03-22,14,11,0,11,76.34,2
Amber Trail,2023-02-12,4,11,0,11,76.34,0
Sudden Market,2023-01-20,10,11,0,11,76.34,0
Animal Academy,2023-02-22,4,11,0,11,76.34,0
The Last Craftsman,2023-03-07,4,11,0,11,76.34,1
Midnight Dash,2023-01-09,4,11,0,11,76.34,0
Safehouse,2023-01-22,6,11,0,11,76.34,0
A Symmetric Escape,2023-02-17,3,11,0,11,76.34,0
The Magical Land of Canada,2023-03-08,3,11,0,11,76.34,0
Armored Us,2023-03-13,2,11,0,11,76.34,0
Hentai Oni,2023-03-17,4,11,0,11,76.34,0
My Furry Dragon,2023-03-25,20,23,2,25,76.25,1
Zero Wing,2023-02-14,10,23,2,25,76.25,1
Hentai EroElf,2023-01-06,7,23,2,25,76.25,0
Hole in Won,2023-01-03,12,23,2,25,76.25,0
Sexy New Year,2023-03-31,15,23,2,25,76.25,0
STRIPPERS,2023-04-07,14,23,2,25,76.25,0
The Moroccan Castle 3 : Behind The Secrets,2023-03-20,4,23,2,25,76.25,0
Anemoiapolis,2023-03-04,241,455,108,563,76.24,8
Drago Noka,2023-01-12,357,93,17,110,76.18,17
Gravity Field,2023-02-22,2386,228,50,278,76.14,15
PolyShot,2023-03-09,13,17,1,18,76.13,0
Slime Warfare,2023-02-17,17,17,1,18,76.13,1
Sister Wish,2023-03-02,7,17,1,18,76.13,0
Hentai Hanako,2023-01-28,5,17,1,18,76.13,0
Grappling Dash,2023-01-27,4,28,3,31,76.12,0
Silent Nights,2023-03-10,10,38,5,43,76.09,2
Tristia:legacy,2023-01-20,38,33,4,37,76.08,3
Посылка,2023-02-01,11,33,4,37,76.08,0
Made In Ohio,2023-03-07,5,33,4,37,76.08,1
Scrappage,2023-02-25,16,33,4,37,76.08,0
Fantasy World Souls,2023-02-16,18,33,4,37,76.08,2
The Last Haven,2023-02-18,429,1603,427,2030,76.04,47
The Last Starship,2023-02-15,329,189,41,230,75.92,65
Gripper,2023-03-29,33,42,6,48,75.88,2
Femdom Wife Game - Zoe,2023-01-27,26,22,2,24,75.86,4
Pocket Harvest,2023-01-16,24,22,2,24,75.86,12
回溯勇者 Backdate Hero,2023-01-13,9,22,2,24,75.86,0
Maiz,2023-01-20,5,22,2,24,75.86,0
Oxygen,2023-04-07,554,107,21,128,75.82,272
Nayla's Castle,2023-03-01,29,37,5,42,75.82,1
黄泉：孤岛惊魂,2023-01-20,93,299,70,369,75.8,0
RAIDBORN,2023-03-29,121,90,17,107,75.78,11
Chronicles of Forgotten Tears,2023-03-10,82,32,4,36,75.77,8
The Forgotten Tapes: Analog Nightmares,2023-01-23,9,32,4,36,75.77,0
Last Devil,2023-03-16,282,418,102,520,75.76,38
GunnRunner,2023-03-17,6,10,0,10,75.71,0
Alcyon Infinity,2023-01-16,4,10,0,10,75.71,0
Mortal Meal,2023-02-16,3,10,0,10,75.71,0
They came from another planet,2023-04-02,2,10,0,10,75.71,0
Collab Ball,2023-01-11,6,10,0,10,75.71,0
LiMiT's Escape Room Games 2,2023-01-10,9,10,0,10,75.71,0
Mini Star Bakery,2023-01-02,11,10,0,10,75.71,0
<|>,2023-02-24,2,10,0,10,75.71,0
Monster Racing League,2023-03-23,10,10,0,10,75.71,0
Martial Fire,2023-01-19,2,10,0,10,75.71,0
Car Parking 2,2023-01-19,4,10,0,10,75.71,0
Paper Flight - Beyond Time,2023-03-10,5,10,0,10,75.71,0
Old Bira´s Farm,2023-01-31,2,10,0,10,75.71,0
Flaming Thunderer,2023-01-20,4,10,0,10,75.71,0
Lone Traveler,2023-01-20,3,10,0,10,75.71,0
Tracadie Bird Shit,2023-01-20,2,10,0,10,75.71,0
Ara and the Empty Universe,2023-01-30,3,10,0,10,75.71,0
Alien Battlefield,2023-01-27,2,10,0,10,75.71,0
Tide Girl: Phenomena,2023-03-25,3,10,0,10,75.71,0
Best Pearl,2023-03-08,3,10,0,10,75.71,0
Crazy Clown,2023-03-08,3,10,0,10,75.71,0
Grounded Sim: Steam Edition,2023-02-17,2,10,0,10,75.71,0
Sally Can't Sleep,2023-02-20,9,10,0,10,75.71,0
Before The Green Moon,2023-03-14,7,10,0,10,75.71,0
SKIP,2023-03-14,4,10,0,10,75.71,0
SEX × HEX,2023-03-31,8,10,0,10,75.71,3
Archery Simulator,2023-03-13,3,16,1,17,75.64,0
Archery Simulator,2023-03-13,3,16,1,17,75.64,0
Archery Simulator,2022-09-21,2,22,3,25,73.75,0
Archery Simulator,2022-09-21,2,22,3,25,73.75,0
AI Stories,2023-03-16,4,16,1,17,75.64,0
Violet Wisteria,2023-02-09,5,16,1,17,75.64,0
Spy Bros. (Pipi & Bibi's DX),2023-02-14,7,16,1,17,75.64,0
Weekend Warriors MMA,2023-02-05,13,16,1,17,75.64,1
Extra Lives,2023-03-01,8,16,1,17,75.64,1
学園ハンサムFighters,2023-04-05,12,16,1,17,75.64,0
Second Front,2023-01-31,351,318,76,394,75.63,27
恶魔酱的五日恶戏,2023-01-20,14,41,6,47,75.62,0
异世界的城主大人,2023-02-26,171,215,49,264,75.58,87
Beaver Clicker,2023-02-07,61,36,5,41,75.53,11
Idle Simple RPG,2023-03-30,261,36,5,41,75.53,178
Undisputed,2023-01-31,7433,5254,1536,6790,75.46,722
Cursed Mansion,2023-03-30,5,31,4,35,75.46,0
Pixel Town: Akanemachi Mystery,2023-02-25,66,31,4,35,75.46,0
Uragun,2023-03-30,52,108,22,130,75.45,4
WWE 2K23,2023-03-17,6535,1152,313,1465,75.44,"2,412"
Hexrogue,2023-01-08,28,21,2,23,75.44,0
Tick Tack Puppet,2023-03-20,90,21,2,23,75.44,1
Mystic Gate,2023-02-10,17,21,2,23,75.44,1
仙界之剑 仙王少女战记,2023-01-25,31,21,2,23,75.44,0
Forrest of Frequencies,2023-01-31,4,21,2,23,75.44,0
The Crown of Wu,2023-03-24,11,26,3,29,75.41,2
Predictors,2023-01-18,11,26,3,29,75.41,0
Ortharion : The Last Battle Prologue,2023-03-31,27,26,3,29,75.41,5
Hentai SportsGirl,2023-01-16,6,26,3,29,75.41,0
Napoleon Maiden ~A maiden without the word impossible~,2023-01-27,12,40,6,46,75.36,0
富甲天下3,2023-01-05,648,234,55,289,75.35,60
The Escape: Together,2023-01-13,69,196,45,241,75.33,2
Cyclo Chambers,2023-02-21,127,66,12,78,75.33,3
Scars Above,2023-02-28,330,369,92,461,75.31,13
The Obscura Experiment,2023-03-07,30,53,9,62,75.29,0
Writer's Life,2023-01-18,143,390,98,488,75.28,5
Corpse Keeper,2023-02-15,1007,706,188,894,75.23,36
The True Love Rings,2023-01-17,75,285,70,355,75.12,2
The Art of War: Card Game,2023-02-01,14,30,4,34,75.12,2
Ragdoll: Fall and Destroy,2023-02-01,6,30,4,34,75.12,0
Punch A Bunch,2023-01-20,219,488,127,615,75.1,2
Johnny Chainsaw,2023-03-28,8,15,1,16,75.1,0
There Will Be Ink,2023-03-10,8,15,1,16,75.1,0
Undeadly,2023-04-06,16,15,1,16,75.1,2
Aery VR - Little Bird Adventure,2023-01-13,4,15,1,16,75.1,0
Twin Cobra,2023-02-14,21,15,1,16,75.1,0
Last Kids on Earth: Hit the Deck!,2023-02-17,6,15,1,16,75.1,0
Land of Towers,2023-01-23,4,15,1,16,75.1,0
光明王传说,2023-01-05,6,15,1,16,75.1,0
Notes of the Young Lady: In Turbulent Times,2023-02-20,18,15,1,16,75.1,3
Manga Maker's Mega Milkers,2023-02-17,9,15,1,16,75.1,2
2D Dawg 2,2023-04-07,49,97,20,117,75.08,3
Touge Shakai,2023-01-08,176,207,49,256,75.05,51
Save the Earth ECO inc.,2023-01-11,33,56,10,66,75.02,1
Hotel Renovator,2023-03-07,2503,874,240,1114,75.01,356
Ball laB 2,2023-03-03,3,9,0,9,75.0,0
Hentai Series,2023-02-11,3,9,0,9,75.0,0
Hero Team,2023-01-05,82,9,0,9,75.0,0
New Roots,2023-03-16,3,9,0,9,75.0,0
Battle Tracks,2023-03-29,4,9,0,9,75.0,0
Rise of Fox Hero,2023-02-17,5,9,0,9,75.0,0
Knight And Mourning,2023-04-11,7,9,0,9,75.0,0
My Landlord is a Futanari,2023-03-18,3,9,0,9,75.0,0
The Exile of Aphrodisia (2023),2023-02-17,34,9,0,9,75.0,0
Flowa,2023-03-06,5,9,0,9,75.0,1
Long Dream,2023-04-11,66,9,0,9,75.0,13
Forests Fields and Fortresses,2023-04-05,11,9,0,9,75.0,1
Tropical Resort Story,2023-04-10,113,9,0,9,75.0,59
The Helper,2023-01-31,1,9,0,9,75.0,0
Full Gear,2023-03-01,4,9,0,9,75.0,0
名媛模拟器,2023-03-29,5,9,0,9,75.0,0
The Last Hair,2023-03-31,5,9,0,9,75.0,0
Strip Fighter ZERO,2023-04-08,9,9,0,9,75.0,0
Pretty Dinosaur Adventures of Ancient Earth VR,2023-02-02,1,9,0,9,75.0,0
Brazen Thief,2023-01-12,3,9,0,9,75.0,0
Infinite Mirror,2023-01-12,3,9,0,9,75.0,0
勇士末路 The End of Warriors,2023-03-24,6,9,0,9,75.0,0
Yellow History,2023-03-31,3,9,0,9,75.0,1
小白的保卫战 Xiaobai's defense war,2023-02-12,2,9,0,9,75.0,0
Dare To Spread,2023-04-01,5,9,0,9,75.0,0
BadMan,2023-02-23,4,9,0,9,75.0,0
Fateweaver: Smash or Pass,2023-04-10,7,9,0,9,75.0,0
The Devilry Reservation,2023-03-06,2,9,0,9,75.0,0
Not Anyone's Business But My Own,2023-03-07,3,9,0,9,75.0,0
Glory Room,2023-03-29,3,9,0,9,75.0,0
Around The World,2023-02-02,5,20,2,22,74.99,0
OutWave,2023-01-05,5,20,2,22,74.99,0
Naive Riri,2023-03-29,9,20,2,22,74.99,0
Dungeons of Aether,2023-02-28,565,257,63,320,74.98,11
Midnight Scenes: From the Woods,2023-02-09,14,64,12,76,74.96,0
Winning Post 10,2023-03-30,5115,51,9,60,74.85,"2,522"
Demon Queen Melissa,2023-01-21,189,55,10,65,74.81,3
Clarent Saga: Chronicles,2023-01-23,4,29,4,33,74.78,0
Steelborn,2023-03-07,19,46,8,54,74.65,0
Engine Evolution 2022,2023-02-21,168,568,155,723,74.63,38
GRUNND,2023-01-26,13,24,3,27,74.63,0
Inward,2023-02-02,12,24,3,27,74.63,2
T.D.Z. 3 Dark Way of Stalker,2023-03-31,7,24,3,27,74.63,0
inziva,2023-04-10,26,24,3,27,74.63,1
Scrap Riders,2023-01-09,5,14,1,15,74.53,0
They Came From the Sky 2,2023-01-11,4,14,1,15,74.53,1
Crystal Riders VR,2023-03-10,2,14,1,15,74.53,0
Mayhem Heroes,2023-02-10,4,14,1,15,74.53,0
Nixxsz Castle,2023-02-14,4,14,1,15,74.53,0
Life is Pain,2023-03-03,3,14,1,15,74.53,0
Hentai Festival,2023-03-10,4,14,1,15,74.53,0
Hentai Snowy,2023-03-24,6,14,1,15,74.53,0
MITE,2023-02-13,6,37,6,43,74.51,1
Onion Assault,2023-01-26,5,19,2,21,74.51,0
Cockroach Simulator house of survive,2023-02-28,4,19,2,21,74.51,0
人形限界,2023-03-06,40,19,2,21,74.51,1
Kitchen Chaos,2023-01-30,9,19,2,21,74.51,0
Little Monki,2023-04-01,5,19,2,21,74.51,1
Back To Ashes,2023-02-20,8,85,18,103,74.49,0
Lovebirb,2023-03-15,32,81,17,98,74.47,3
Filthy Animals | Heist Simulator,2023-04-04,496,73,15,88,74.42,9
Disfigure: Prologue,2023-03-31,43,28,4,32,74.41,10
Kowloon's Curse: Lost Report,2023-03-22,11,45,8,53,74.4,1
Queen's Brothel,2023-01-05,126,61,12,73,74.38,7
The Magical Mixture Mill,2023-04-05,282,57,11,68,74.37,75
3001: A MILF Odyssey,2023-01-26,61,53,10,63,74.37,18
The Ouroboros King,2023-02-27,160,72,15,87,74.25,13
SEX with HITLER: 2069,2023-03-24,71,87,19,106,74.22,0
Gatedelvers,2023-02-20,33,36,6,42,74.2,2
Blinded by Fear,2023-01-19,6,23,3,26,74.2,0
An Adventurer's Gallantry,2023-04-05,4,8,0,8,74.19,0
Walthros: Renewal,2023-03-15,3,8,0,8,74.19,0
Rooftop Renegade,2023-02-16,5,8,0,8,74.19,0
VRNOID,2023-03-04,3,8,0,8,74.19,1
Moxie's Lemon,2023-02-10,2,8,0,8,74.19,0
Blue Fish Yokohama,2023-02-17,3,8,0,8,74.19,0
Ghosted,2023-02-27,4,8,0,8,74.19,0
An Architect's Adventure,2023-03-25,6,8,0,8,74.19,2
Defend from Candyland!,2023-02-20,2,8,0,8,74.19,0
Hotdog Quest: One With Everything,2023-03-05,2,8,0,8,74.19,0
DC's Justice League: Cosmic Chaos,2023-03-10,13,8,0,8,74.19,0
Jigsaw Puzzles Infinite,2023-04-02,17,8,0,8,74.19,2
Code Rivals,2023-02-05,6,8,0,8,74.19,0
Boulette Hell,2023-03-10,2,8,0,8,74.19,0
DOWNFALLEN,2023-01-27,2,8,0,8,74.19,0
Putin Destroys Alien,2023-01-16,2,8,0,8,74.19,0
Chibi Ninja Shino-kun: Treasure of Demon Tower,2023-03-14,2,8,0,8,74.19,2
Chess Morph: The Queen's Wormholes,2023-03-01,2,8,0,8,74.19,0
幻境咖啡馆,2023-01-18,3,8,0,8,74.19,0
1WEEK,2023-04-07,4,8,0,8,74.19,0
Stay Human,2023-01-26,2,8,0,8,74.19,0
Protos Magos,2023-03-30,3,8,0,8,74.19,0
Xploquest 3,2023-01-20,3,8,0,8,74.19,0
GyroGunner,2023-02-24,5,8,0,8,74.19,0
Kristal Mağara,2023-02-05,3,8,0,8,74.19,0
SEARCH ALL - WORMS,2023-01-23,3,8,0,8,74.19,0
Fumpers,2023-02-14,3,8,0,8,74.19,0
Pigskin Punter!,2023-02-08,2,8,0,8,74.19,0
Banana Attack VR,2023-02-10,5,8,0,8,74.19,0
Gender Dysphoria,2023-04-06,3,8,0,8,74.19,0
Puffin Ball Drop,2023-04-04,3,8,0,8,74.19,0
Romantic Shooter,2023-03-24,4,8,0,8,74.19,0
That Racecar Game,2023-03-27,2,8,0,8,74.19,0
Natti,2023-02-16,95,60,12,72,74.17,4
Passed Out,2023-03-13,157,123,29,152,74.12,4
Call of Duty®: Black Ops Cold War,2023-03-08,2369,1345,403,1748,74.1,570
Mahokenshi,2023-01-24,408,248,65,313,74.05,2
微光之镜 Glimmer in Mirror,2023-01-10,702,500,141,641,74.0,3
Niflhel's Fables: The Book of Gypsies,2023-02-16,3,18,2,20,74.0,0
Richman 8,2023-03-16,57,18,2,20,74.0,24
Delve Into Pawssion,2023-03-30,21,18,2,20,74.0,1
Lawless West,2023-01-07,7,31,5,36,73.93,0
Indies' Lies,2023-01-16,606,422,118,540,73.91,42
Rogue Spirit,2023-03-07,112,114,27,141,73.91,1
The Maiden the Butler and the Witch,2023-02-11,114,35,6,41,73.89,3
Stories from the Outbreak,2023-03-27,74,35,6,41,73.89,7
Esperia ~ Uprising of the Scarlet Witch ~,2023-03-01,10,13,1,14,73.89,3
Cynthia: Hidden in the Moonshadow,2023-04-10,30,13,1,14,73.89,12
Inside My Mind 2,2023-02-12,2,13,1,14,73.89,0
A Traveler to unknown Thule,2023-02-13,6,13,1,14,73.89,0
SENTINEL,2023-01-29,4,13,1,14,73.89,0
Retail Wars,2023-01-17,11,13,1,14,73.89,2
Diesel The Pug Warrior,2023-01-30,6,13,1,14,73.89,0
In The Gym,2023-01-27,4,13,1,14,73.89,0
Dungeon Core,2023-03-02,35,39,7,46,73.87,1
Kawaii Neko Girls 2,2023-03-06,38,110,26,136,73.86,4
違う冬のぼくら,2023-02-13,395,261,70,331,73.83,87
Rytmos,2023-02-28,12,22,3,25,73.75,1
Reclusive,2023-03-28,5,22,3,25,73.75,0
Anthology of Fear,2023-03-17,84,112,27,139,73.67,5
Blocky Dungeon,2023-04-06,50,26,4,30,73.63,13
Active Soccer 2023,2023-03-29,14,26,4,30,73.63,3
Pan'orama: Prologue,2023-02-23,23,26,4,30,73.63,3
Fantasy Jigsaw Puzzles,2023-01-02,18,26,4,30,73.63,1
Abyss Of Fire,2023-02-28,5,26,4,30,73.63,0
The Last Shot,2023-02-16,14,42,8,50,73.59,0
Shiitake Showdown,2023-01-14,15,42,8,50,73.59,0
古剑奇闻录,2023-03-10,44,34,6,40,73.56,4
Initial Drift Online,2023-03-30,826,1717,540,2257,73.52,21
Class Reunion Chat Room,2023-02-24,23,86,20,106,73.51,1
奉天白事铺,2023-01-13,121,172,45,217,73.48,2
Timestamps: Unconditional Love,2023-01-07,146,64,14,78,73.45,13
The Fairy's Secret,2023-02-06,10,17,2,19,73.45,0
A Maiden Astrologer Divines the Future,2023-01-25,5,17,2,19,73.45,0
Commander: Modern War,2023-01-28,8,17,2,19,73.45,1
Temporian,2023-03-30,34,17,2,19,73.45,8
SEX with HITLER: WW2,2023-03-11,588,103,25,128,73.41,0
House Designer : Fix & Flip,2023-02-21,42,60,13,73,73.38,6
Unmatched: Digital Edition,2023-02-28,124,106,26,132,73.35,11
Farming Fever: Cooking Games,2023-02-17,169,99,24,123,73.34,34
Tainted Grail: The Fall of Avalon,2023-03-30,932,503,149,652,73.29,189
Heal & Hurt,2023-02-24,41,143,37,180,73.29,3
The Pioneers: surviving desolation,2023-01-20,393,196,53,249,73.27,11
Prison Life 2,2023-03-30,30,21,3,24,73.27,14
The end is nahual: If I may say so,2023-02-17,6,21,3,24,73.27,1
Deluge: Sermon for the Dead,2023-02-14,8,21,3,24,73.27,1
Cruise Ship Manager: Prologue - Maiden Voyage,2023-02-22,15,21,3,24,73.27,1
Haulin' Oats,2023-03-09,5,7,0,7,73.26,0
Mystica,2023-01-19,7,7,0,7,73.26,1
Imposters,2023-02-01,9,7,0,7,73.26,0
Stellar Mess: The Princess Conundrum (Chapter 1),2023-02-27,4,7,0,7,73.26,0
Dust Devil,2023-03-01,2,7,0,7,73.26,0
Warmonium,2023-01-26,5,7,0,7,73.26,0
Catoise,2023-01-24,2,7,0,7,73.26,0
THNT,2023-03-21,2,7,0,7,73.26,0
Disc Golf : Game On,2023-03-25,9,7,0,7,73.26,1
Oliver,2023-04-05,2,7,0,7,73.26,0
Farm Under Fire,2023-04-08,11,7,0,7,73.26,0
Fluff,2023-01-06,3,7,0,7,73.26,0
DELETE AFTER READING,2023-03-14,7,7,0,7,73.26,0
Traveler's Game,2023-04-05,5,7,0,7,73.26,0
Roxy Raccoon 2: Topsy-Turvy,2023-04-03,4,7,0,7,73.26,0
Age of Gladiators Reforged,2023-03-27,19,7,0,7,73.26,5
Ovivim,2023-03-13,8,7,0,7,73.26,0
Moonflower,2023-03-25,3,7,0,7,73.26,0
Olympiades,2023-01-19,12,7,0,7,73.26,0
Susurye of Shadows,2023-01-12,4,7,0,7,73.26,0
Caverns of Mars: Recharged,2023-03-09,6,7,0,7,73.26,1
Keeper Of The Valley,2023-03-01,2,7,0,7,73.26,0
Idle interstellar Factory 2,2023-02-08,9,7,0,7,73.26,1
Clash: Robot Detective - Complete Edition,2023-01-02,2,7,0,7,73.26,0
Crypt Architect,2023-01-06,6,7,0,7,73.26,0
Sokoball Dreams,2023-03-01,3,7,0,7,73.26,0
Dyztopia: Post-Human RPG,2023-01-06,6,7,0,7,73.26,0
Pretty Hentai Girls,2023-01-25,3,7,0,7,73.26,0
Sorcerers Summit,2023-04-05,3,7,0,7,73.26,0
Duplicado,2023-02-01,2,7,0,7,73.26,0
Rhythm Taichi XR,2023-02-22,2,7,0,7,73.26,1
Spider Hunter,2023-02-10,2,7,0,7,73.26,0
Winnie The Pooh: The Serial Killer,2023-02-09,2,7,0,7,73.26,0
Daily Dadish,2023-02-07,6,7,0,7,73.26,0
The Grindstone,2023-02-25,7,7,0,7,73.26,3
Destiny Duel,2023-03-18,6,7,0,7,73.26,0
Hkons Beanrunner,2023-02-21,3,7,0,7,73.26,0
R.A.T.T.Z. Maze,2023-03-31,1,7,0,7,73.26,0
Pasha Planet: Reborn,2023-03-03,3,7,0,7,73.26,0
Nuke Survivors,2023-02-24,2,7,0,7,73.26,0
Jump By Coronho: Chapter 2,2023-03-13,3,7,0,7,73.26,0
Digital Diamond Baseball V11,2023-03-31,30,7,0,7,73.26,14
I commissioned some dogs,2023-03-30,9,7,0,7,73.26,0
Hentai Pool,2023-03-22,3,7,0,7,73.26,0
Hentai SpaceSuit,2023-04-07,5,7,0,7,73.26,2
線路の祠 ～真の放置ゲーム～,2023-04-05,114,7,0,7,73.26,101
The 2nd page of the medical examination diary: Another story of exciting days of me and my senpai,2023-02-01,16,33,6,39,73.21,1
Tyrant Quest,2023-02-13,56,25,4,29,73.2,1
Power of Ten,2023-01-11,101,115,29,144,73.19,0
Warplanes: Battles over Pacific,2023-01-26,20,91,22,113,73.19,2
Shopping Center Tycoon,2023-02-27,15,29,5,34,73.19,1
VentureVerse: Legend of Ulora,2023-03-09,5,12,1,13,73.19,0
The Trasamire Campaigns,2023-02-03,4,12,1,13,73.19,0
异世界杂货铺 Skyscraper In Another World,2023-03-26,33,12,1,13,73.19,0
Arcade Party,2023-02-22,21,12,1,13,73.19,0
Zoe The Exhibitionist,2023-03-21,44,12,1,13,73.19,3
My Gym Mommy Treats Me Like A Kid,2023-01-23,6,12,1,13,73.19,0
Rich Uncle: A Gay Adventure,2023-02-14,8,12,1,13,73.19,1
Hearth's Light Potion Shop,2023-03-24,6,12,1,13,73.19,1
Hentai Military,2023-02-24,4,12,1,13,73.19,0
Soul Knight: The Forest of Spirits,2023-02-16,3,12,1,13,73.19,0
Ghosts from the House of Flesh,2023-03-09,4,12,1,13,73.19,0
二分之一,2023-03-17,599,371,108,479,73.17,7
Rune Teller,2023-02-09,175,320,92,412,73.16,1
Xuan-Yuan Sword: The Cloud of Han,2023-01-12,77,48,10,58,73.16,9
Hentai Aim Trainer 2,2023-02-13,7,44,9,53,73.08,1
Forsake,2023-03-31,71,114,29,143,73.06,22
Arthas - The Game,2023-02-17,195,301,87,388,73.0,0
叫我皇上,2023-01-20,202,425,127,552,72.96,21
三国：寻将传,2023-03-10,45,36,7,43,72.93,18
Life of Delta,2023-03-13,25,47,10,57,72.9,0
Total Tank Generals,2023-03-30,174,82,20,102,72.86,51
Gjallarhorn,2023-01-10,7,16,2,18,72.86,0
Metal Black™ S-Tribute,2023-02-01,10,16,2,18,72.86,0
Rat Cage,2023-01-31,11,16,2,18,72.86,1
阴阳林,2023-01-12,14,16,2,18,72.86,0
Hentai Gyaru,2023-01-24,5,16,2,18,72.86,0
Hyper Pop,2023-02-27,4,16,2,18,72.86,0
Hentai Room,2023-01-09,5,20,3,23,72.76,0
NecroCity: Prologue,2023-03-06,39,20,3,23,72.76,4
Cyber West: Hidden Object Games - Western,2023-01-27,9,20,3,23,72.76,2
Pet Dragon Girl,2023-01-13,6,20,3,23,72.76,0
Infinite Incantation,2023-02-28,10,24,4,28,72.75,0
The Crimping,2023-03-10,4,24,4,28,72.75,0
いっき団結,2023-02-15,3487,476,146,622,72.7,153
Knights of Braveland,2023-02-16,524,134,36,170,72.69,56
Definitely Not Fried Chicken,2023-01-18,789,430,132,562,72.57,126
Wayhaven Chronicles: Book Three,2023-04-06,604,56,13,69,72.49,92
Fraymakers,2023-01-19,2333,627,199,826,72.48,23
The Utility Room,2023-02-06,4,31,6,37,72.48,0
Lockes The Thief,2023-02-09,2,11,1,12,72.42,0
Exiori,2023-01-10,7,11,1,12,72.42,0
Rival Rides,2023-01-24,6,11,1,12,72.42,0
Flightpath,2023-01-26,5,11,1,12,72.42,1
Frido,2023-01-19,5,11,1,12,72.42,0
Loot Express Delivery Service,2023-02-10,4,11,1,12,72.42,0
A Bit of Tactics,2023-01-19,25,11,1,12,72.42,0
Love Quest,2023-02-14,6,11,1,12,72.42,0
MalovMetaArt,2023-02-28,3,11,1,12,72.42,0
Kingdom Run VR,2023-03-03,2,11,1,12,72.42,0
圣魂,2023-01-25,9,11,1,12,72.42,0
F1 Crazy Stunts,2023-02-06,3,11,1,12,72.42,0
Galactic Empire,2023-03-09,3,11,1,12,72.42,0
Draft - In the woods,2023-03-10,2,11,1,12,72.42,1
Uncle Kenny The Game,2023-03-15,3,11,1,12,72.42,0
Hentai MatureCat,2023-03-31,5,11,1,12,72.42,0
被坏女人骗成冒险者!,2023-04-04,13,11,1,12,72.42,0
Jumping Cat,2023-01-16,6,27,5,32,72.38,0
Masterplan Tycoon,2023-03-09,427,240,71,311,72.35,17
Forbidden Escape,2023-01-25,7,23,4,27,72.28,0
Umichan Two Scoops,2023-01-13,9,23,4,27,72.28,1
Milky Quest II,2023-01-28,298,149,42,191,72.26,6
King Fishing,2023-02-09,47,114,31,145,72.24,2
Multiplayer Cowboys,2023-02-14,10,34,7,41,72.24,0
For The Fatherland,2023-03-05,4,15,2,17,72.22,0
Peppa Pig: World Adventures,2023-03-17,9,15,2,17,72.22,1
Australian Football Coach 2023,2023-03-09,29,15,2,17,72.22,3
Fish Simulator: Agonik Lake,2023-03-16,4,15,2,17,72.22,0
Don't get lost,2023-02-01,248,195,57,252,72.2,4
The True Slime King,2023-02-04,3,6,0,6,72.17,0
Iconic,2023-01-08,2,6,0,6,72.17,0
VOENKOMAT,2023-04-08,19,6,0,6,72.17,1
Demolition Master,2023-02-28,5,6,0,6,72.17,0
Damn Ropes,2023-03-25,3,6,0,6,72.17,0
PictoPull,2023-03-29,4,6,0,6,72.17,0
星の欠片の物語。しかけ版,2023-01-19,6,6,0,6,72.17,0
Cubelander,2023-01-25,3,6,0,6,72.17,0
惊魂日记 FrightDiary,2023-03-12,7,6,0,6,72.17,0
Hexes,2023-03-27,2,6,0,6,72.17,0
Flip of Light,2023-01-23,3,6,0,6,72.17,0
Bolt Bot Screwy Viruses,2023-02-16,3,6,0,6,72.17,0
Creatures of Energy,2023-01-02,3,6,0,6,72.17,0
Biz Builder Delux,2023-03-20,35,6,0,6,72.17,10
Anomaly,2023-02-03,2,6,0,6,72.17,0
Blade-Shift Rage,2023-02-24,1,6,0,6,72.17,0
Me in the Office,2023-02-17,3,6,0,6,72.17,0
Unluckily in Love,2023-03-13,5,6,0,6,72.17,0
SEKISAI puzzle action,2023-01-06,2,6,0,6,72.17,0
The Search For Paradisus,2023-01-11,1,6,0,6,72.17,0
Bazooka Cat: First Episode,2023-02-14,5,6,0,6,72.17,0
Knight vs Giant: The Broken Excalibur Prologue,2023-02-02,8,6,0,6,72.17,0
Kanji Drive,2023-01-08,3,6,0,6,72.17,0
Zombies Rocket Boom Boom,2023-01-30,1,6,0,6,72.17,0
Button VR,2023-02-03,2,6,0,6,72.17,0
Resultarias,2023-01-23,3,6,0,6,72.17,0
Double Line Confrontation：New World（双线交锋：新世界）,2023-01-03,2,6,0,6,72.17,0
Chex,2023-01-21,2,6,0,6,72.17,0
Another Man's Wife,2023-01-21,13,6,0,6,72.17,1
Blockappend,2023-03-01,3,6,0,6,72.17,0
Castle Capture Topkapi,2023-01-27,6,6,0,6,72.17,0
Crunch Time,2023-03-20,1,6,0,6,72.17,0
Mistcaller,2023-02-12,81,6,0,6,72.17,0
告死天使复仇之夜 Death Angel Nightmare,2023-03-09,5,6,0,6,72.17,0
虚空灵药园,2023-01-20,2,6,0,6,72.17,0
T-Rex Dinosaur Game,2023-01-20,2,6,0,6,72.17,0
Fliese,2023-02-02,3,6,0,6,72.17,0
Kinda Knirpsi,2023-03-10,7,6,0,6,72.17,0
Mullet Hell,2023-02-01,3,6,0,6,72.17,0
Beef Jerky,2023-02-17,1,6,0,6,72.17,0
Stack Machines,2023-02-25,4,6,0,6,72.17,0
Swords & Bones 3,2023-03-06,3,6,0,6,72.17,0
TankLab,2023-02-12,5,6,0,6,72.17,0
My Time,2023-02-24,3,6,0,6,72.17,1
Polyrhythm Master,2023-02-15,2,6,0,6,72.17,0
Strawb,2023-03-10,1,6,0,6,72.17,0
Cx6,2023-03-10,2,6,0,6,72.17,0
三国世界,2023-03-31,4,6,0,6,72.17,0
Hentai Blackjack,2023-02-24,3,6,0,6,72.17,0
The Faceless,2023-02-20,2,6,0,6,72.17,0
ウワガキアイ,2023-02-25,7,6,0,6,72.17,0
pWordle,2023-03-21,3,6,0,6,72.17,0
擒贼先擒王,2023-03-24,2,6,0,6,72.17,0
The Dorm Is Yours!,2023-03-10,10,6,0,6,72.17,0
Vom Drachentöten,2023-03-23,3,6,0,6,72.17,0
Deep Space Scoundrel,2023-03-30,3,6,0,6,72.17,0
Lust Girls,2023-03-24,2,6,0,6,72.17,0
Eloriasha,2023-03-25,3,6,0,6,72.17,0
Stickman Trenches,2023-03-01,308,222,66,288,72.16,30
Gnome Online,2023-01-24,34,71,18,89,72.09,4
Sexy Valentine 🍆 💜,2023-02-28,29,30,6,36,72.09,0
The paladin & The succubi servant,2023-01-16,10,37,8,45,72.05,1
The Moon Hell,2023-02-16,27,87,23,110,72.04,0
天下霸圖,2023-02-17,678,125,35,160,72.03,32
Merge & Blade,2023-02-28,152,93,25,118,71.98,4
隐秘的角落,2023-01-18,711,323,101,424,71.95,2
Rescue Dash Time Management Game,2023-01-12,62,80,21,101,71.95,27
Deathtide Survivors,2023-01-26,14,26,5,31,71.94,5
Trenches - World War 1 Horror Survival Game,2023-01-20,19,83,22,105,71.91,0
LOST EGG 3: The Final,2023-01-02,225,40,9,49,71.89,8
No One Survived,2023-01-14,4632,2292,805,3097,71.87,"1,341"
Encoded War,2023-01-21,9,22,4,26,71.78,0
Idle Banshee Alliance,2023-01-11,34,22,4,26,71.78,10
Golfie,2023-01-19,175,153,45,198,71.73,5
Opportunity: A Sugar Baby Story,2023-02-13,31,36,8,44,71.7,3
It's Hasegawa-san!?,2023-02-28,18,46,11,57,71.66,0
Swords Fantasy: Battlefield,2023-03-06,5,18,3,21,71.63,0
Eon of the Green,2023-01-25,4,18,3,21,71.63,0
Tower Walker,2023-02-08,105,39,9,48,71.57,17
Lust Theory Season 2,2023-01-28,881,243,76,319,71.56,212
Theseus Protocol,2023-01-17,175,196,60,256,71.56,4
Hell Slayer,2023-01-26,7,10,1,11,71.55,2
FreedroidRPG,2023-01-20,4,10,1,11,71.55,1
Robot Revolt,2023-01-21,13,10,1,11,71.55,2
Lady of Dreams,2023-02-15,7,10,1,11,71.55,0
Welcome to Levy,2023-03-02,4,10,1,11,71.55,1
Don't Wake God,2023-02-21,4,10,1,11,71.55,0
Cracks In Hell,2023-01-17,14,10,1,11,71.55,1
Astral Coconut,2023-02-10,6,10,1,11,71.55,0
ParaSHOTical ARKtiviBeatings,2023-02-14,5,10,1,11,71.55,0
CalmLine,2023-03-06,3,10,1,11,71.55,0
Noah Please!,2023-03-02,2,10,1,11,71.55,0
shita ni,2023-03-03,6,10,1,11,71.55,0
Dark rune,2023-03-20,6,10,1,11,71.55,0
Experiment: one,2023-03-28,4,10,1,11,71.55,0
WITCH RACE,2023-04-07,22,10,1,11,71.55,1
Hidden World 4 Top-Down 3D,2023-03-23,5,10,1,11,71.55,0
Women's Prison 絕對人權女子監獄,2023-02-17,217,87,24,111,71.52,6
Hardwar,2023-02-15,8,14,2,16,71.52,1
Agony VR,2023-04-05,10,14,2,16,71.52,1
軍靴をはいた猫,2023-02-24,23,14,2,16,71.52,0
Time Lock VR-episode Lumber Room,2023-02-22,5,14,2,16,71.52,0
奔向繁星,2023-02-20,3,14,2,16,71.52,0
Crimson Connect Origin,2023-03-31,30,32,7,39,71.49,0
Sea of Craft,2023-03-10,303,331,107,438,71.48,1
Kitten Lost Her Box,2023-02-27,6,25,5,30,71.48,0
Neko Hentai Girl: Beach Match-3,2023-03-17,7,25,5,30,71.48,0
BlackHoopS,2023-01-29,26,42,10,52,71.46,1
Deliver Us Mars,2023-02-02,1113,796,274,1070,71.41,72
Non-Stop Raiders,2023-01-23,20,35,8,43,71.35,0
The Great War: Western Front™,2023-03-30,3564,756,261,1017,71.31,"1,031"
Melon Journey: Bittersweet Memories,2023-04-06,32,28,6,34,71.26,4
DiktaPunk: Fighting for Dominance,2023-02-23,44,28,6,34,71.26,0
Angel's Gear,2023-02-14,44,79,22,101,71.21,1
Secret Camera,2023-02-13,75,100,29,129,71.16,5
Desktop Sex Doll,2023-01-19,27,60,16,76,71.12,0
Persona 3 Portable,2023-01-19,3515,2005,733,2738,71.08,505
PROTOCOL 11,2023-02-23,5,17,3,20,71.0,0
Bank Robber,2023-02-04,7,17,3,20,71.0,0
Sue Shi Survival,2023-04-11,8,17,3,20,71.0,1
Elowen's Light,2023-03-15,4,17,3,20,71.0,0
Traveler's Bastion,2023-03-11,37,17,3,20,71.0,3
Towers Deck,2023-02-01,3,17,3,20,71.0,0
RINA RhythmERROR,2023-03-10,84,140,43,183,70.99,1
Mechaneer Resta's Grand Adventure,2023-04-08,57,24,5,29,70.99,3
創業王 CEO,2023-01-20,22,24,5,29,70.99,3
ISEKAI FRONTLINE,2023-03-16,778,349,117,466,70.98,66
Howl of Iron,2023-01-12,5,34,8,42,70.98,1
SEXTS,2023-01-31,126,205,66,271,70.9,4
Tune in to the show,2023-03-03,80,37,9,46,70.88,17
Kabaret,2023-04-04,17,5,0,5,70.84,1
SUFFER 2,2023-01-13,3,5,0,5,70.84,0
Alive Paint,2023-03-25,2,5,0,5,70.84,0
Horror haze,2023-01-17,3,5,0,5,70.84,0
Aurora's Journey and the Pitiful Lackey,2023-01-13,3,5,0,5,70.84,0
MORE ENEMIES,2023-01-08,2,5,0,5,70.84,0
Bowerwhelm,2023-03-31,5,5,0,5,70.84,0
FurBalls Racing,2023-01-30,8,5,0,5,70.84,0
Sukebe Beach,2023-03-09,4,5,0,5,70.84,0
Lilith,2023-02-11,1,5,0,5,70.84,0
Idol Hell,2023-03-03,2,5,0,5,70.84,0
Lovely Neko Girl,2023-04-06,4,5,0,5,70.84,0
Bite Nite,2023-01-03,5,5,0,5,70.84,0
Sticky Notes,2023-04-07,3,5,0,5,70.84,0
Deck 'Em!,2023-03-07,3,5,0,5,70.84,0
The Janus Problem,2023-02-25,2,5,0,5,70.84,0
The Wolf of Derevnya,2023-04-04,2,5,0,5,70.84,1
决斗小爱,2023-02-14,3,5,0,5,70.84,0
Stories From the Cores,2023-02-05,3,5,0,5,70.84,0
Changeling Charade,2023-02-09,16,5,0,5,70.84,0
Animal Across: Afrika,2023-03-10,3,5,0,5,70.84,0
Beneath Her Starry Sky,2023-01-04,3,5,0,5,70.84,0
The Specter Chronicles: Episode 1 - The False Prophet,2023-02-28,3,5,0,5,70.84,0
Drive Maker,2023-02-05,3,5,0,5,70.84,0
Doodle World Deluxe,2023-03-31,2,5,0,5,70.84,0
XenoFeud,2023-01-02,1,5,0,5,70.84,0
Subtension,2023-03-28,3,5,0,5,70.84,0
Take Care VR,2023-01-05,3,5,0,5,70.84,1
Choi,2023-01-12,2,5,0,5,70.84,0
Agent Roy - Secure The Temple,2023-01-05,2,5,0,5,70.84,0
Easy Game,2023-01-30,3,5,0,5,70.84,0
World of Turtle,2023-01-13,2,5,0,5,70.84,0
Zooblies,2023-01-16,2,5,0,5,70.84,0
Inmortuae Metuunt: Rise of The Undead,2023-01-16,5,5,0,5,70.84,0
Domination - War of Nations,2023-02-10,6,5,0,5,70.84,0
Highway Speeder,2023-01-12,5,5,0,5,70.84,0
Tamerlane,2023-01-25,2,5,0,5,70.84,0
Lost Oliver,2023-03-09,3,5,0,5,70.84,0
Minibots TD,2023-02-15,4,5,0,5,70.84,0
NTR'd By Clumsiness,2023-03-14,6,5,0,5,70.84,0
Zombie Apocalypse - The Last Fortress,2023-02-14,1,5,0,5,70.84,0
Castle Kingdom Wars,2023-02-28,5,5,0,5,70.84,0
Tears RAIN: Tears of Goddess,2023-02-05,3,5,0,5,70.84,0
Geko: entering the pipe,2023-03-09,3,5,0,5,70.84,0
My Fake Goblin Wife,2023-03-10,2,5,0,5,70.84,0
Radical Road,2023-03-25,2,5,0,5,70.84,0
Porndle,2023-03-25,3,5,0,5,70.84,0
Manual Overcycle,2023-02-28,1,5,0,5,70.84,0
Super Crane Bug,2023-03-10,3,5,0,5,70.84,0
Ultimate Anime Jigsaw Puzzle,2023-03-10,4,5,0,5,70.84,2
Damsels of Vice 2: Project Mesmer,2023-03-10,6,5,0,5,70.84,1
House Sitter Escape Game,2023-03-15,3,5,0,5,70.84,0
MeiQi:Phoenix and the Chamber of Secrets,2023-03-17,9,5,0,5,70.84,0
KingMini,2023-03-27,6,5,0,5,70.84,0
Chinese Chess Party (Xiangqi),2023-03-22,4,5,0,5,70.84,0
Rescue Agency: The Kidnapper of happiness,2023-04-06,4,5,0,5,70.84,1
Winnie-the-Pooh's book writing speedrunner,2023-04-05,5,5,0,5,70.84,0
GENIE,2023-04-07,7,5,0,5,70.84,0
ROGUE-FP,2023-03-30,3,5,0,5,70.84,0
Perseus: Titan Slayer,2023-02-13,1218,204,66,270,70.82,2
GPRO,2023-02-13,215,40,10,50,70.81,26
Dreadful River,2023-02-28,17,27,6,33,70.81,1
Happy Mining,2023-02-16,21,27,6,33,70.81,1
Car Racing Highway Driving Simulator real parking driver sim speed traffic deluxe 2022,2023-01-11,15,27,6,33,70.81,1
Stacks:Space!,2023-02-20,45,27,6,33,70.81,1
魔王终局,2023-04-09,142,27,6,33,70.81,19
Echoes of Mayhem,2023-02-20,6,13,2,15,70.75,0
SourceWorlds,2023-03-10,10,13,2,15,70.75,0
Waitventure,2023-01-01,47,13,2,15,70.75,2
Starshifter,2023-02-15,7,13,2,15,70.75,1
Small Town Detective,2023-03-01,3,13,2,15,70.75,0
Artur's Pinball,2023-01-10,2,13,2,15,70.75,1
Project Liminal Redux,2023-03-23,6,13,2,15,70.75,0
ALPEN GHOUL: Prologue,2023-03-20,5,13,2,15,70.75,0
Trash Horror Collection 3,2023-03-24,8,13,2,15,70.75,0
Finger is 300 bugs,2023-03-28,6,13,2,15,70.75,0
Uncharted Ocean 2,2023-01-13,261,100,30,130,70.72,59
NRG,2023-02-08,23,46,12,58,70.72,0
GirlFriend VR,2023-01-04,15,46,12,58,70.72,1
Out of the Park Baseball 24,2023-03-24,1354,146,46,192,70.7,"1,087"
Slave Doll,2023-03-28,96,94,28,122,70.7,7
Fruit Ninja VR 2,2023-04-07,28,49,13,62,70.69,2
Windmills,2023-02-03,8,20,4,24,70.68,1
Spaceflight Factory : Prologue,2023-01-20,20,20,4,24,70.68,0
Burst Hero,2023-01-01,13,20,4,24,70.68,0
Romancelvania,2023-03-07,122,76,22,98,70.64,4
Minds of Nations,2023-04-11,127,360,124,484,70.59,12
David Slade Mysteries: Case Files,2023-01-25,5,9,1,10,70.57,0
Kiteboarding Pro,2023-01-02,4,9,1,10,70.57,1
SALVATIONLAND,2023-02-15,3,9,1,10,70.57,0
Be A Rock,2023-03-31,3,9,1,10,70.57,0
The Smile Alchemist,2023-03-03,11,9,1,10,70.57,0
Decent Checkers,2023-02-05,4,9,1,10,70.57,0
Golf 5 eClub,2023-02-24,5,9,1,10,70.57,0
Rogue Blaster,2023-01-26,24,9,1,10,70.57,1
Yummy Girls 3,2023-02-16,1,9,1,10,70.57,0
Paccsu,2023-01-06,13,9,1,10,70.57,1
Sapu,2023-01-03,3,9,1,10,70.57,0
Chadboy,2023-03-13,4,9,1,10,70.57,0
Fremdganger - The Cheating Demon,2023-03-02,2,9,1,10,70.57,0
THE ABYSS,2023-03-03,3,9,1,10,70.57,0
Hot Secretary Puzzle,2023-03-31,2,9,1,10,70.57,0
Irradiant,2023-03-31,5,9,1,10,70.57,0
Goblin Lord wants me to become a Virgin Wizard by Managing The Brothel!?,2023-04-07,53,9,1,10,70.57,14
Find It,2023-04-10,2,9,1,10,70.57,0
三国英雄传豪华版,2023-01-20,187,136,43,179,70.54,49
Role of Hex,2023-02-21,51,36,9,45,70.52,7
Wilderless,2023-01-10,9,36,9,45,70.52,0
Cooking Live: Restaurant Game,2023-02-02,529,471,166,637,70.51,105
Hunting Labyrinth,2023-02-15,21,23,5,28,70.48,0
只兔：不灭的勇者,2023-03-08,33,107,33,140,70.47,1
Mr. Mat Hematic,2023-02-26,9,42,11,53,70.44,0
Storyteller,2023-03-23,1493,1072,397,1469,70.42,179
REMEDIUM: Sentinels,2023-02-28,36,63,18,81,70.41,3
Kunado Chronicles,2023-04-07,102,48,13,61,70.41,19
My MILF Stepmom💋,2023-04-07,159,126,40,166,70.35,66
The Last Worker,2023-03-30,25,29,7,36,70.25,1
Saga of Sins,2023-03-30,17,29,7,36,70.25,0
Grand Theft Auto: Vice City - The Definitive Edition,2023-01-19,955,703,258,961,70.22,63
Ravenswatch,2023-04-06,10018,1561,594,2155,70.21,"2,071"
My Life as a Cult Leader,2023-03-25,110,65,19,84,70.19,11
Anime vs Evil: Apocalypse,2023-02-16,39,44,12,56,70.11,0
ULTRA LMAD,2023-01-20,12,19,4,23,70.08,0
The Cleaner,2023-01-05,3,19,4,23,70.08,0
The Cleaner,2023-01-05,3,19,4,23,70.08,0
The Cleaner,2022-05-05,17,59,32,91,61.03,0
The Cleaner,2022-05-05,17,59,32,91,61.03,0
Hot Pussy College 2 🍓🔞,2023-03-31,77,87,27,114,70.01,5
Bomberpet,2023-03-24,6,12,2,14,69.91,0
实习班主任 Practice Teacher,2023-01-13,7,12,2,14,69.91,0
It Returned To The Desert,2023-02-15,4,12,2,14,69.91,0
Open Fishing XL,2023-01-23,3,12,2,14,69.91,0
The Last Hike,2023-02-17,6,12,2,14,69.91,0
Crazy Hill Racing,2023-02-15,3,12,2,14,69.91,1
Break Everything - Park,2023-01-27,2,12,2,14,69.91,0
Little Garden,2023-03-10,7,12,2,14,69.91,0
全城警戒,2023-04-07,15,12,2,14,69.91,2
我在地球修仙有系统,2023-04-03,2385,371,134,505,69.86,"1,048"
Rabbit Hole Chapter 1,2023-01-31,15,28,7,35,69.8,0
Phantom Alchemy ~Silvia's Dynamic Urban Planning~,2023-01-07,87,31,8,39,69.77,0
Flash Party,2023-01-10,828,817,313,1130,69.61,201
December 1914,2023-02-24,15,15,3,18,69.59,1
HIYOKU NO TORI,2023-02-22,8,15,3,18,69.59,0
Horror Tale 2: Samantha,2023-01-11,5,15,3,18,69.59,0
沃瑞尔,2023-02-14,11,15,3,18,69.59,0
Kagura Survivors: Endless Night,2023-04-01,1397,365,135,500,69.46,197
Fantasia Sango Mysteria,2023-01-11,740,314,115,429,69.46,216
Comic Book Company Manager,2023-02-21,3,8,1,9,69.44,0
Solbane,2023-03-31,3,8,1,9,69.44,0
SD Shin Kamen Rider Rumble,2023-04-05,48,8,1,9,69.44,0
Frebbventure,2023-02-23,5,8,1,9,69.44,1
The Burrito Quest,2023-01-16,3,8,1,9,69.44,0
Spirits' Creek,2023-01-13,3,8,1,9,69.44,0
Broken Blade: Prelude,2023-02-10,5,8,1,9,69.44,0
Paradise Cleaning!- sex-loving family -,2023-03-10,4,8,1,9,69.44,0
80's Mania,2023-01-20,3,8,1,9,69.44,0
NOT ME,2023-03-02,6,8,1,9,69.44,0
PAIN: Below Sanity,2023-01-20,4,8,1,9,69.44,0
Monster Waifu,2023-01-15,3,8,1,9,69.44,0
Legacy Of The Pact,2023-01-06,5,8,1,9,69.44,0
Stonga Bird,2023-01-26,2,8,1,9,69.44,0
Friendly Facade,2023-01-27,3,8,1,9,69.44,0
Broombot Battlegrounds,2023-02-14,5,8,1,9,69.44,0
SuccuSeka: Resist Succubus Temptation,2023-02-14,4,8,1,9,69.44,1
WAR ON THE STREET,2023-03-20,2,8,1,9,69.44,0
Neko-chan's Club,2023-03-03,5,8,1,9,69.44,0
ENEMIES: GONE SUBURBAN,2023-03-26,5,8,1,9,69.44,3
Sexy Nurse Puzzle,2023-04-08,3,8,1,9,69.44,0
Hentai Miko,2023-03-07,3,8,1,9,69.44,1
Hentai Miko,2023-03-07,3,8,1,9,69.44,0
Hentai Miko,2022-12-30,4,19,2,21,74.51,1
Hentai Miko,2022-12-30,4,19,2,21,74.51,0
Hentai Puzzle Quest,2023-03-23,2,8,1,9,69.44,0
Munchkin Digital,2023-03-09,678,415,155,570,69.43,77
PERISH,2023-02-02,491,275,100,375,69.42,7
Surviving the Abyss,2023-01-17,1079,407,152,559,69.41,34
Amigo: Kebab Simulator,2023-04-03,38,33,9,42,69.36,16
Arena Renovation - First Job,2023-03-14,59,27,7,34,69.33,3
Darkness Revenge,2023-01-10,34,27,7,34,69.33,0
无限投影2,2023-04-01,128,27,7,34,69.33,22
Xuan-Yuan Sword: The Clouds Faraway,2023-01-12,81,50,15,65,69.3,7
Dust & Neon,2023-02-16,190,136,47,183,69.26,2
KartRider: Drift,2023-01-10,4748,2513,1025,3538,69.23,617
明日战线 - 放置就能开宝箱（放置挂机探索卡牌策略）,2023-03-28,303,159,56,215,69.2,154
Turbo Cat Fight,2023-02-14,3,4,0,4,69.2,0
Intern Pursuit Game,2023-01-10,2,4,0,4,69.2,0
Hill Agency: PURITY&decay,2023-03-31,3,4,0,4,69.2,0
Working Zombies Steam Edition,2023-03-07,4,4,0,4,69.2,0
Avoid the rain,2023-01-18,4,4,0,4,69.2,0
Field of Arms: Tactics,2023-03-06,3,4,0,4,69.2,0
The Thing from Nowhere,2023-02-01,2,4,0,4,69.2,0
Marco & Polo,2023-02-14,1,4,0,4,69.2,0
The Secret Life of Dorian Pink,2023-03-27,4,4,0,4,69.2,1
Cursed Road Convoy,2023-12-31,3,4,0,4,69.2,0
Burning Vengeance,2023-04-02,2,4,0,4,69.2,0
Steel Defier,2023-03-24,3,4,0,4,69.2,0
The Lost Condor,2023-01-06,2,4,0,4,69.2,0
Super Trunko Go,2023-02-23,2,4,0,4,69.2,0
The Nameless Braves: Heaven,2023-03-01,3,4,0,4,69.2,0
Ball Go Home,2023-02-09,11,4,0,4,69.2,0
Flag Sweeper,2023-03-24,3,4,0,4,69.2,0
Triopticon三昧,2023-03-13,3,4,0,4,69.2,0
The Sea of Death,2023-02-17,3,4,0,4,69.2,0
Going Deep,2023-02-18,3,4,0,4,69.2,0
Enworden,2023-01-05,2,4,0,4,69.2,0
Diamond Skeeball,2023-02-01,6,4,0,4,69.2,0
Attack on King: Reloaded,2023-01-20,3,4,0,4,69.2,0
Code Rubik,2023-01-13,1,4,0,4,69.2,0
Servants of Sumomon,2023-02-28,1,4,0,4,69.2,0
Retired Waves,2023-02-22,2,4,0,4,69.2,0
So Much Stuff,2023-03-02,6,4,0,4,69.2,0
Shong,2023-02-24,4,4,0,4,69.2,0
MEKA SIGURAT,2023-01-22,2,4,0,4,69.2,0
Alien on the Radar,2023-02-17,2,4,0,4,69.2,0
Amabilly,2023-01-30,3,4,0,4,69.2,0
Forbidden City Journey,2023-03-12,2,4,0,4,69.2,0
Rapscallions On Deck,2023-01-19,3,4,0,4,69.2,0
Orbital Bombardment,2023-04-05,2,4,0,4,69.2,0
Little Circuit,2023-03-08,2,4,0,4,69.2,0
Across the Valley,2023-04-06,4,4,0,4,69.2,0
Aim Expert,2023-02-06,4,4,0,4,69.2,0
FaceValue,2023-02-21,2,4,0,4,69.2,0
The Motorcycle,2023-01-09,2,4,0,4,69.2,0
Temanava,2023-03-31,3,4,0,4,69.2,0
ForRest Paper Doll,2023-03-17,7,4,0,4,69.2,0
God Busters : Who watches the watchers?,2023-01-19,3,4,0,4,69.2,0
Dawn of Griseo,2023-01-06,3,4,0,4,69.2,0
You're Fired! Revenge!,2023-01-16,4,4,0,4,69.2,0
The Green Room Experiment (Episode 1),2023-01-28,5,4,0,4,69.2,0
307 Racing,2023-02-27,2,4,0,4,69.2,0
MageBall,2023-01-30,2,4,0,4,69.2,0
Parts Unknown,2023-02-12,4,4,0,4,69.2,0
Pact of Steel,2023-03-01,3,4,0,4,69.2,0
House of Shadow,2023-01-16,2,4,0,4,69.2,0
Hentai Puzzle Universe,2023-02-05,3,4,0,4,69.2,0
Hentai Casual Slider,2023-01-26,2,4,0,4,69.2,0
Keyboard Warrior: Dreamstate Prologue,2023-01-22,4,4,0,4,69.2,0
PHANOTIA I: ESCAVIVE,2023-01-31,2,4,0,4,69.2,0
Metal March: Beginner Experience,2023-01-24,4,4,0,4,69.2,0
Mega Sudoku,2023-02-16,2,4,0,4,69.2,0
Simnetzero,2023-01-30,4,4,0,4,69.2,0
Fantasya,2023-02-03,3,4,0,4,69.2,0
Go Over The Edge,2023-02-10,5,4,0,4,69.2,0
Food Maze,2023-02-03,5,4,0,4,69.2,0
Animal portal,2023-01-31,2,4,0,4,69.2,0
Cycle Chaser H-5,2023-03-31,2,4,0,4,69.2,0
I commissioned some bees 14,2023-03-02,6,4,0,4,69.2,0
Ultimate Flight Simulator Pro,2023-02-02,3,4,0,4,69.2,0
Find the Energy,2023-02-27,3,4,0,4,69.2,0
Fingerspelling Unleashed - BANZSL Edition,2023-02-28,2,4,0,4,69.2,0
Running Riot,2023-03-17,3,4,0,4,69.2,0
Engineering - Mystery of the ancient clock,2023-02-10,2,4,0,4,69.2,0
Spellarium 9,2023-02-21,10,4,0,4,69.2,1
Pencil Plus: The Wrath of The Spankster,2023-03-28,3,4,0,4,69.2,0
Mind The Pipes!,2023-02-14,1,4,0,4,69.2,0
My Lovely Pets Collector's Edition,2023-02-20,4,4,0,4,69.2,0
Polar Bear Game,2023-02-10,2,4,0,4,69.2,0
DownhillMadness,2023-02-27,2,4,0,4,69.2,0
Vivat Sloboda,2023-02-09,3,4,0,4,69.2,0
Gunpowder Punk,2023-03-01,3,4,0,4,69.2,0
連縁无現里 ~ Misremembered Memories,2023-02-16,3,4,0,4,69.2,0
GHOST: AC-130 CLOSE AIR SUPPORT,2023-02-23,5,4,0,4,69.2,0
雷雨漫漫,2023-03-21,2,4,0,4,69.2,0
IN THE BUILDING: HAMSTERS,2023-02-24,4,4,0,4,69.2,0
Ugmania,2023-03-09,5,4,0,4,69.2,0
Free Kick Football: 3D Soccer,2023-02-24,2,4,0,4,69.2,0
CardShark,2023-03-01,2,4,0,4,69.2,0
Water tank| 貯水槽,2023-03-30,15,4,0,4,69.2,1
大懒子勇闯魔王城,2023-03-06,2,4,0,4,69.2,0
The Adventures of LinShanHai - Chapter2:Bus Bombing,2023-03-03,5,4,0,4,69.2,0
Hentai Casual Slider 3,2023-03-05,2,4,0,4,69.2,0
Goospace,2023-03-18,2,4,0,4,69.2,0
Flea the Cat,2023-03-17,2,4,0,4,69.2,0
Walstikski,2023-03-16,3,4,0,4,69.2,0
All Goblin,2023-03-29,3,4,0,4,69.2,0
Text Twist 3,2023-04-30,3,4,0,4,69.2,0
Showrunner,2023-01-17,53,44,13,57,69.18,2
The King's Dilemma: Chronicles,2023-01-30,155,63,20,83,69.08,4
Gloria Victis,2023-02-07,4185,6685,2825,9510,69.01,930
Project: Mirror,2023-01-24,131,113,39,152,68.99,5
Mori Carta,2023-02-20,17,11,2,13,68.97,1
The Hero We Need,2023-02-21,4,11,2,13,68.97,0
Practisim Designer,2023-02-14,15,11,2,13,68.97,4
Way of the Wizard,2023-01-19,4,11,2,13,68.97,0
Break Everything - Living room,2023-01-19,2,11,2,13,68.97,1
Cats in Heat - Summer Fling,2023-02-28,8,11,2,13,68.97,0
Kiss Effect,2023-02-17,6,11,2,13,68.97,0
Station 99,2023-03-20,4,11,2,13,68.97,0
Castle Rush Zombies,2023-03-31,2,11,2,13,68.97,0
순정만화가 너무 어려워!,2023-04-05,17,11,2,13,68.97,0
降妖神兵,2023-03-30,63,54,17,71,68.87,1
The Library of Babel,2023-04-07,23,26,7,33,68.83,3
Jump Fucker,2023-02-28,10,26,7,33,68.83,0
Upgrade VR,2023-02-03,5,14,3,17,68.8,0
Sidestep Legends,2023-01-09,11,14,3,17,68.8,1
Hungry Caveman,2023-02-04,7,14,3,17,68.8,0
Endless Fireworks Simulator,2023-02-06,7,14,3,17,68.8,0
Dark Dead,2023-04-07,5,14,3,17,68.8,0
Ultimate Admiral: Dreadnoughts,2023-01-25,2081,2461,1027,3488,68.79,995
DzombZ,2023-01-30,8,23,6,29,68.78,0
Misteri Rumah Pak RT,2023-02-18,12,23,6,29,68.78,0
소울 가디언즈,2023-02-22,311,190,70,260,68.75,96
Your Story,2023-01-19,13,20,5,25,68.75,0
Overrun Survivors,2023-02-16,12,20,5,25,68.75,1
RINA RhythmERROR：Prologue,2023-02-17,8,17,4,21,68.75,0
Miniland Adventure,2023-04-10,274,48,15,63,68.7,58
The Cenozoic Era,2023-01-20,227,234,88,322,68.69,79
Battle of Vukovar: Rain of Steel,2023-01-31,13,34,10,44,68.6,0
Death Roads: Tournament,2023-03-28,379,155,57,212,68.51,72
Street Lords,2023-02-07,48,58,19,77,68.5,2
Cockville,2023-02-07,50,50,16,66,68.49,24
A Sex Slave's Love Story,2023-02-28,58,73,25,98,68.35,3
蛇香之夜 ～Allure of MUSK～　第一夜　欧洲篇,2023-02-14,257,101,36,137,68.34,5
最终堡垒,2023-02-21,11,25,7,32,68.31,1
I'm looking for 3024 people,2023-02-03,8,36,11,47,68.3,0
Bobo The Cat,2023-01-05,6,22,6,28,68.2,0
IN THE BUILDING: CATS 3,2023-01-05,6,22,6,28,68.2,0
THE MEME HUNTER,2023-03-02,8,49,16,65,68.19,0
Pillazon: MMO Drug Lord Tycoon,2023-01-13,15,33,10,43,68.18,0
PyroSlam: VR Table Tennis,2023-02-16,6,7,1,8,68.15,0
Chippy & Noppo,2023-03-08,49,7,1,8,68.15,4
Warspace,2023-03-27,5,7,1,8,68.15,1
Warspace,2023-03-27,5,7,1,8,68.15,0
Warspace,2022-01-18,1,1,5,6,35.22,1
Warspace,2022-01-18,1,1,5,6,35.22,0
The Forest Cathedral,2023-03-14,5,7,1,8,68.15,0
Revenge on the Streets 3,2023-01-02,2,7,1,8,68.15,0
Mudoba,2023-01-05,3,7,1,8,68.15,0
Exhibitors,2023-04-08,7,7,1,8,68.15,2
Hot Coffe Shop,2023-03-31,5,7,1,8,68.15,0
A Matter of Principle,2023-01-19,2,7,1,8,68.15,0
Only A Dream,2023-01-13,2,7,1,8,68.15,0
Sphere Game Legendary,2023-01-06,3,7,1,8,68.15,0
Dark Desire Mute 1,2023-01-14,4,7,1,8,68.15,0
Torico's b-day gift hunt,2023-02-23,2,7,1,8,68.15,0
Hike Valley,2023-01-20,2,7,1,8,68.15,0
Slayin 2,2023-03-30,5,7,1,8,68.15,0
Gallery Manager,2023-02-17,5,7,1,8,68.15,0
Lana and the Milking Table,2023-03-31,6,7,1,8,68.15,0
Flip That Coin!,2023-03-02,3,7,1,8,68.15,0
Vincent's Horror Story,2023-02-27,6,7,1,8,68.15,0
Lost World,2023-02-05,104,144,54,198,68.11,7
Rhythm Brawl,2023-04-11,15,102,37,139,68.1,0
Cuckold Life Simulator 😳🔞,2023-01-21,517,87,31,118,68.1,0
Friend or Foe,2023-01-23,13,19,5,24,68.1,0
SUR5,2023-04-01,23,19,5,24,68.1,11
Poozle Mania,2023-03-31,38,19,5,24,68.1,3
Spatial Terminal,2023-01-13,7,19,5,24,68.1,0
Planet Fights,2023-03-24,22,30,9,39,68.05,3
Kai Yuan,2023-03-13,12,16,4,20,68.0,2
山门与幻境,2023-01-15,438,443,181,624,67.97,95
The Walking Dead: Saints & Sinners - Chapter 2: Retribution,2023-03-21,532,417,170,587,67.95,104
The Unbeatable Path,2023-04-06,10,10,2,12,67.93,3
I Will Be There,2023-02-14,3,10,2,12,67.93,0
Escape Dream,2023-03-13,11,10,2,12,67.93,0
Gehinnom: Prologue,2023-02-27,7,10,2,12,67.93,0
Turbo Racing,2023-03-20,4,10,2,12,67.93,0
Hot Therapy,2023-04-06,33,10,2,12,67.93,3
Aquatico,2023-01-12,937,379,154,533,67.92,59
Beyond Contact,2023-04-04,291,318,128,446,67.91,214
Elemental Raiders,2023-01-16,51,76,27,103,67.91,7
Touch Me,2023-01-12,21,35,11,46,67.9,0
Goblins of Elderstone,2023-03-08,163,209,82,291,67.87,5
Power Chord,2023-01-26,167,68,24,92,67.8,1
Administrators,2023-03-25,4,24,7,31,67.76,0
Мафия 1x1,2023-03-10,34,24,7,31,67.76,4
异世重生 : 枪之勇者 Reincarnation : Hero of the Gun,2023-02-27,98,32,10,42,67.75,18
Deadly Broadcast,2023-02-02,131,319,130,449,67.7,0
《蜀山：初章》网络版,2023-04-06,1429,337,138,475,67.67,957
Altf42,2023-03-30,149,104,39,143,67.64,99
Otherwar,2023-02-27,33,42,14,56,67.6,0
Alignment,2023-03-10,15,21,6,27,67.59,1
Derealized,2023-03-13,10,29,9,38,67.58,0
Dark Prospect,2023-03-05,25,57,20,77,67.55,0
Make Her Cum,2023-02-02,47,108,41,149,67.51,2
Magic Pussy: Chapter 1,2023-04-08,321,160,63,223,67.48,31
paradise of desire,2023-01-11,62,69,25,94,67.46,0
Tiny Troopers: Global Ops,2023-03-09,16,18,5,23,67.4,0
Ultra Blade,2023-02-24,7,18,5,23,67.4,0
Road 96: Mile 0,2023-04-04,484,277,114,391,67.39,67
13iew,2023-04-04,32,26,8,34,67.39,7
Axiom,2023-01-01,34,88,33,121,67.38,2
CyberCum: Pussy Attack❗️,2023-04-01,82,73,27,100,67.27,0
Prepare Uranus: Exploring Black Holes for Adults,2023-01-06,39,41,14,55,67.24,1
Survival Nation,2023-02-02,38,68,25,93,67.23,6
Industries of Titan,2023-01-31,2217,917,404,1321,67.19,33
Heavyarms Assemble: WWII,2023-02-03,76,63,23,86,67.19,0
Boxing Gym Story,2023-02-13,242,48,17,65,67.09,13
A Foreign World,2023-02-06,83,28,9,37,67.09,6
鞭炮&烟花：春节模拟器Firecrackers&fireworks：china new year simulation,2023-01-26,20,28,9,37,67.09,0
Light of Alariya,2023-03-01,80,84,32,116,67.07,2
Bleak Faith: Forsaken,2023-03-10,1793,1152,515,1667,67.06,47
Super Sketch Bob,2023-03-16,1,3,0,3,67.06,0
Asteroid Defender!,2023-02-09,1,3,0,3,67.06,0
Unification,2023-03-01,2,3,0,3,67.06,0
Johnny Lionface,2023-02-20,6,3,0,3,67.06,0
Lab Chaos,2023-03-04,1,3,0,3,67.06,0
Knight Of The Parking Lot,2023-01-25,2,3,0,3,67.06,0
Hana's Campus Life,2023-03-31,3,3,0,3,67.06,0
PocketCiv,2023-01-17,6,3,0,3,67.06,0
Virtual Near Death Experience,2023-03-11,1,3,0,3,67.06,0
Iron Age,2023-04-05,2,3,0,3,67.06,0
Iron Age,2023-04-05,2,3,0,3,67.06,0
Iron Age,2022-03-18,7,16,6,22,63.88,0
Iron Age,2022-03-18,7,16,6,22,63.88,0
Anti Frank's Wrath,2023-01-13,4,3,0,3,67.06,0
Super Puzzle Cross,2023-03-29,3,3,0,3,67.06,0
BLINNK and the Vacuum of Space,2023-01-17,7,3,0,3,67.06,0
Just a SHMUP?,2023-02-24,2,3,0,3,67.06,0
Space Warden,2023-03-16,1,3,0,3,67.06,0
Sinister,2023-01-25,1,3,0,3,67.06,0
Lucie's Potager,2023-02-16,2,3,0,3,67.06,0
Automoji,2023-03-08,10,3,0,3,67.06,0
Boot & Shoot,2023-02-22,2,3,0,3,67.06,0
Seven Spirits,2023-01-20,2,3,0,3,67.06,0
Game Cycle,2023-01-20,2,3,0,3,67.06,0
The Cursed Knight,2023-02-09,2,3,0,3,67.06,0
Rat Chef,2023-02-26,2,3,0,3,67.06,0
MouseLife - Parenthood,2023-03-31,1,3,0,3,67.06,0
Ghosts over the Water: Changing the Tides of Japan's Future,2023-03-31,3,3,0,3,67.06,0
Home By The River,2023-02-15,3,3,0,3,67.06,0
Cryogenesis,2023-03-07,1,3,0,3,67.06,0
Breakthrough,2023-02-16,2,3,0,3,67.06,0
Flight Level,2023-02-28,6,3,0,3,67.06,0
Spike Mtn,2023-03-30,1,3,0,3,67.06,0
Hex,2023-01-27,1,3,0,3,67.06,0
Hex,2023-01-27,1,3,0,3,67.06,0
Hex,2017-11-06,3,32,5,37,74.28,0
Hex,2017-11-06,3,32,5,37,74.28,0
The Legend of Gandar II,2023-01-02,2,3,0,3,67.06,0
Corgi Cove,2023-02-14,3,3,0,3,67.06,0
Thelos,2023-01-12,2,3,0,3,67.06,0
Huntscape,2023-03-31,4,3,0,3,67.06,0
Fusion Paradox,2023-04-10,2,3,0,3,67.06,0
Mount Farewell,2023-01-27,3,3,0,3,67.06,0
Bugs and Bullets,2023-02-03,4,3,0,3,67.06,0
A Lone Piece,2023-03-02,2,3,0,3,67.06,0
OSAWARI HOCKEY えんこちゃん,2023-01-12,2,3,0,3,67.06,0
Elemental Adventure,2023-02-17,6,3,0,3,67.06,0
The Last Werewolf,2023-02-23,2,3,0,3,67.06,0
BBirthday - Visual Novel,2023-01-20,4,3,0,3,67.06,0
Warung Nasi Campur,2023-02-09,1,3,0,3,67.06,0
Island Bender,2023-03-31,4,3,0,3,67.06,0
Race Code,2023-04-30,2,3,0,3,67.06,0
The Soul's Choice,2023-01-27,7,3,0,3,67.06,0
タイピングで愛を伝えよ,2023-01-05,2,3,0,3,67.06,0
Amanda's Magic Book 6,2023-01-12,3,3,0,3,67.06,0
City Z,2023-04-07,5,3,0,3,67.06,2
City Z,2023-04-07,5,3,0,3,67.06,0
City Z,2016-04-29,920,12,14,26,47.58,2
City Z,2016-04-29,920,12,14,26,47.58,0
Hide and Seek,2023-02-10,16,3,0,3,67.06,0
Hide and Seek,2023-02-10,16,3,0,3,67.06,1
Hide and Seek,2023-02-10,16,3,0,3,67.06,4
Hide and Seek,2023-02-10,16,3,0,3,67.06,0
Hide and Seek,2021-11-13,35,84,23,107,71.54,0
Hide and Seek,2021-11-13,35,84,23,107,71.54,1
Hide and Seek,2021-11-13,35,84,23,107,71.54,4
Hide and Seek,2021-11-13,35,84,23,107,71.54,0
Hide and Seek,2019-02-01,63,450,285,735,59.69,0
Hide and Seek,2019-02-01,63,450,285,735,59.69,1
Hide and Seek,2019-02-01,63,450,285,735,59.69,4
Hide and Seek,2019-02-01,63,450,285,735,59.69,0
Hide and Seek,2017-08-31,88,145,223,368,41.19,0
Hide and Seek,2017-08-31,88,145,223,368,41.19,1
Hide and Seek,2017-08-31,88,145,223,368,41.19,4
Hide and Seek,2017-08-31,88,145,223,368,41.19,0
Super Death Game SHOW！VR,2023-04-05,2,3,0,3,67.06,0
MicroCrawl,2023-02-18,2,3,0,3,67.06,0
Mimicry,2023-02-10,4,3,0,3,67.06,0
Mimicry,2023-02-10,4,3,0,3,67.06,9
Mimicry,2023-02-10,4,3,0,3,67.06,0
Mimicry,2022-08-25,20,58,12,70,73.75,0
Mimicry,2022-08-25,20,58,12,70,73.75,9
Mimicry,2022-08-25,20,58,12,70,73.75,0
Mimicry,2020-09-04,3,8,0,8,74.19,0
Mimicry,2020-09-04,3,8,0,8,74.19,9
Mimicry,2020-09-04,3,8,0,8,74.19,0
Catacombs: The Asper Case,2023-03-28,1,3,0,3,67.06,0
Terix Survivors,2023-02-14,1,3,0,3,67.06,0
Dino V. Xeno - Tower Defense,2023-02-24,2,3,0,3,67.06,0
Candy Arkanoid,2023-01-31,2,3,0,3,67.06,0
激活: Activate,2023-01-18,2,3,0,3,67.06,0
NOTHING TO LOSE,2023-02-13,2,3,0,3,67.06,0
混沌骑士,2023-02-28,4,3,0,3,67.06,0
ALPO: Way to home,2023-02-09,2,3,0,3,67.06,0
Wojak Rush,2023-01-29,1,3,0,3,67.06,0
CubeRun 2,2023-03-22,1,3,0,3,67.06,0
Golden Rails: Valuable Package,2023-03-29,30,3,0,3,67.06,10
Autumn-Time Trade-Up,2023-02-25,2,3,0,3,67.06,0
Cave Raider,2023-02-08,2,3,0,3,67.06,0
Project Nosferatu,2023-02-02,2,3,0,3,67.06,0
Disgusting Puzzle,2023-01-27,1,3,0,3,67.06,0
YourTrain,2023-02-07,4,3,0,3,67.06,0
Crystal Storm,2023-03-30,2,3,0,3,67.06,0
Death Road,2023-03-16,1,3,0,3,67.06,0
My Home/Zombie Center,2023-02-17,9,3,0,3,67.06,0
アパシー学校であった怖い話 極,2023-02-15,10,3,0,3,67.06,0
Wak Attak,2023-02-16,1,3,0,3,67.06,0
愛する妻、美咲の不倫証拠 『旦那とどっちが気持ちいい？』→『貴方の方が…あっ、ダメッ、またイッちゃうッ…！』,2023-04-06,1,3,0,3,67.06,0
Hentai Casual Slider 2,2023-02-02,1,3,0,3,67.06,0
Mikrocosmos,2023-02-04,5,3,0,3,67.06,0
Find The Murderer 3,2023-02-11,1,3,0,3,67.06,0
FIGHTING PUDDING,2023-02-18,3,3,0,3,67.06,0
Kiting Mechanics,2023-02-27,3,3,0,3,67.06,0
The Aching,2023-04-05,3,3,0,3,67.06,0
Tartarus Longo Itinere,2023-02-20,2,3,0,3,67.06,0
R-Lyke: Reverse,2023-02-26,2,3,0,3,67.06,0
STIVENELVRO LEGENDS,2023-03-31,3,3,0,3,67.06,0
Knight Raider,2023-02-23,2,3,0,3,67.06,0
Interstellar Conquest,2023-02-27,3,3,0,3,67.06,0
The Fog,2023-02-28,1,3,0,3,67.06,0
The Fog,2023-02-28,1,3,0,3,67.06,0
The Fog,2017-12-01,3,4,8,12,41.03,0
The Fog,2017-12-01,3,4,8,12,41.03,0
Fishjong,2023-03-08,3,3,0,3,67.06,0
Crusader's March,2023-03-06,2,3,0,3,67.06,0
Mimi and Lisa,2023-03-14,3,3,0,3,67.06,1
Jigsaw Puzzles: Fantasy Landscapes,2023-03-07,4,3,0,3,67.06,1
Demons Infernalize,2023-03-30,2,3,0,3,67.06,0
The Orphan,2023-03-29,2,3,0,3,67.06,0
Aquaphobia,2023-03-16,1,3,0,3,67.06,0
Heroes of Eroticism - Amorous Advances,2023-03-24,19,3,0,3,67.06,1
Wizard of Wyndmoor,2023-03-13,1,3,0,3,67.06,0
Mr Rabbit's Cambridge Point and Click Adventure,2023-03-30,1,3,0,3,67.06,0
sunny-place-3: microgods,2023-03-24,4,3,0,3,67.06,0
Boomerang Battles,2023-04-06,3,3,0,3,67.06,0
Furry Furries,2023-03-31,4,3,0,3,67.06,1
Sex Simulator - Office Affairs,2023-03-04,5,3,0,3,67.06,0
Dickland,2023-03-22,3,3,0,3,67.06,0
Mommy Milkers Miko,2023-04-03,8,3,0,3,67.06,1
Final Gun,2023-03-23,6,3,0,3,67.06,0
PolyGunner,2023-04-03,2,3,0,3,67.06,0
The Adventures of LinShanHai - Chapter3:The Headless Woman,2023-03-31,3,3,0,3,67.06,0
스쿨라이프,2023-04-05,3,3,0,3,67.06,0
Little Crab Fisher,2023-04-01,5,3,0,3,67.06,0
Merging Cubes,2023-03-31,1,3,0,3,67.06,0
My Dear Dad 父亲,2023-04-07,6,3,0,3,67.06,0
Vampire Slayer: The Resurrection,2023-02-09,13,33,11,44,67.05,0
Garbage Truck Simulator,2023-02-09,24,33,11,44,67.05,0
Clive 'N' Wrench,2023-02-23,48,60,22,82,67.04,0
Sonic Colors: Ultimate,2023-02-06,90,181,74,255,67.03,7
Pitch Silent,2023-01-17,4,12,3,15,66.98,0
Tristia:restore,2023-01-20,8,12,3,15,66.98,0
Taste of War,2023-01-20,6,12,3,15,66.98,0
Hidden Post-Apocalyptic 2 Top-Down 3D,2023-02-21,2,12,3,15,66.98,0
龙栖,2023-03-24,9,20,6,26,66.94,0
Desktop Dungeons: Rewind - Daily Demo,2023-01-25,27,20,6,26,66.94,2
Trackmania,2023-02-02,2935,1576,718,2294,66.88,"1,328"
Star Survivor - Prologue,2023-02-17,173,83,32,115,66.87,0
Potion Tycoon,2023-03-13,243,113,45,158,66.84,10
Underworld Idle,2023-02-02,765,514,226,740,66.8,476
Mama Die and Retry,2023-01-29,2,9,2,11,66.76,1
Secret Diaries: Manage a Manor,2023-01-30,10,9,2,11,66.76,0
Royal Affairs,2023-03-30,100,9,2,11,66.76,9
Mothership Forever,2023-01-02,4,9,2,11,66.76,0
Nightly Trash,2023-02-26,3,9,2,11,66.76,0
Sakura Battle,2023-02-10,3,9,2,11,66.76,0
Hentai Sera,2023-03-03,6,9,2,11,66.76,0
3 Triplets 18 Tits,2023-04-06,3,9,2,11,66.76,0
Cursed Pantsu,2023-04-04,15,17,5,22,66.66,3
少女的求生之路2：血色洋馆,2023-04-03,7,17,5,22,66.66,0
Strange Aeons,2023-01-13,2,6,1,7,66.62,0
Mix-A-Max,2023-01-06,3,6,1,7,66.62,0
Colony Cephea,2023-03-16,2,6,1,7,66.62,0
Juan Sin Miedo,2023-01-09,2,6,1,7,66.62,0
Gemstones,2023-01-24,3,6,1,7,66.62,0
Metal War,2023-03-25,4,6,1,7,66.62,0
Chasmal,2023-01-31,5,6,1,7,66.62,0
Turtle Racer,2023-02-20,3,6,1,7,66.62,0
Towards the Unknown,2023-02-24,3,6,1,7,66.62,0
The Last Sword,2023-03-10,2,6,1,7,66.62,0
Hentai Beach,2023-01-22,4,6,1,7,66.62,0
Hentai Beach,2023-01-22,4,6,1,7,66.62,1
Hentai Beach,2020-11-13,40,552,52,604,85.37,0
Hentai Beach,2020-11-13,40,552,52,604,85.37,1
That Last Girl,2023-02-12,2,6,1,7,66.62,0
50 Days To Survive,2023-03-03,3,6,1,7,66.62,0
Lost Dream: Darkness,2023-03-17,1,6,1,7,66.62,0
Hentai Pussy 6,2023-02-24,2,6,1,7,66.62,0
Captain Meow,2023-03-02,2,6,1,7,66.62,0
H Girl,2023-03-07,4,6,1,7,66.62,0
Violations Will Be Punished,2023-03-24,5,6,1,7,66.62,0
Under the Sky World,2023-01-05,21,27,9,36,66.57,0
HellFurnace,2023-02-15,20,46,17,63,66.43,0
Blanc,2023-02-14,339,221,95,316,66.41,5
Elder Trial：Prologue,2023-01-25,20,34,12,46,66.41,0
Ex Natura: Nature Corrupted,2023-02-20,6,29,10,39,66.33,0
Adventure's Calling,2023-02-14,6,14,4,18,66.33,0
Pricia Defense,2023-03-25,14,14,4,18,66.33,1
Building our Futature,2023-01-09,23,14,4,18,66.33,1
Mushroom Agent,2023-01-06,2,14,4,18,66.33,0
INVASION,2023-02-10,7,14,4,18,66.33,0
INVASION,2023-02-10,7,14,4,18,66.33,0
INVASION,2020-04-16,2,3,5,8,43.95,0
INVASION,2020-04-16,2,3,5,8,43.95,0
My Dream Girl,2023-01-31,6,24,8,32,66.27,0
HYPERVIOLENT,2023-04-06,26,19,6,25,66.25,3
Hammer Kid,2023-03-13,10,19,6,25,66.25,0
Horror Tale,2023-01-06,10,19,6,25,66.25,0
When All Guys Turned into Girls,2023-01-10,7,19,6,25,66.25,0
Lawnmower Game: Ufo Chase,2023-01-15,3,19,6,25,66.25,0
Multiplayer Werewolves,2023-02-07,7,19,6,25,66.25,0
Phylakterion,2023-02-20,45,36,13,49,66.24,1
Call of Duty®: Modern Warfare®,2023-03-08,1523,779,361,1140,66.13,280
Nadir,2023-02-07,144,137,58,195,66.12,1
Interference: Dead Air,2023-02-02,36,38,14,52,66.09,2
Fight the Landlord,2023-03-31,277,264,117,381,66.07,1
Destinesia,2023-02-16,5,11,3,14,65.93,0
Eternal Fidelity,2023-01-27,3,11,3,14,65.93,0
Jamie's Toy Box,2023-04-10,5,16,5,21,65.86,0
CODE: PANDORA,2023-03-30,30,16,5,21,65.86,2
Heart attack,2023-01-17,7,78,32,110,65.84,0
Gatewalkers,2023-01-12,564,216,96,312,65.82,14
Lone Ruin,2023-01-12,172,97,41,138,65.7,1
Stewart The Fox,2023-01-20,63,99,42,141,65.67,1
Duelyst GG,2023-01-28,16,23,8,31,65.67,1
神国：创造,2023-01-16,83,144,63,207,65.64,0
Grand Theft Auto: San Andreas - The Definitive Edition,2023-01-19,1699,1034,497,1531,65.61,178
Sharded World,2023-01-16,9,18,6,24,65.51,0
Crime Passional,2023-02-14,6,18,6,24,65.51,0
Super Hero Flash Fist,2023-02-14,74,41,16,57,65.47,1
We Are The Caretakers,2023-01-06,16,25,9,34,65.46,0
ILLUMINATI,2023-01-06,15,25,9,34,65.46,0
Dark Skies: The Nemansk Incident,2023-02-24,7,52,21,73,65.42,0
Dawngrown,2023-02-14,4,8,2,10,65.42,0
Raiden IV x MIKADO remix,2023-01-31,9,8,2,10,65.42,0
Revival Quest,2023-03-24,8,8,2,10,65.42,0
Mountain Alpaca,2023-02-19,4,8,2,10,65.42,0
Mythology Waifus Mahjong,2023-03-10,7,8,2,10,65.42,0
Captain The Looper,2023-03-31,5,8,2,10,65.42,0
Hentai Ariel,2023-03-30,4,8,2,10,65.42,0
Ensora,2023-01-17,8,13,4,17,65.38,0
Eastern Europe Bus Sim,2023-01-27,2,13,4,17,65.38,0
Hexagon Puzzle Blocks,2023-01-24,4,13,4,17,65.38,0
Stars End,2023-01-08,244,839,407,1246,65.31,15
初夏倾语 - Summer Whisper,2023-01-13,18,20,7,27,65.25,0
Paranormal Cleanup,2023-02-15,124,90,39,129,65.2,8
Lawbringer,2023-02-03,5,15,5,20,65.0,0
Super Club Soccer,2023-04-01,46,74,32,106,64.96,1
Volzerk : Monsters and Lands Unknown,2023-01-25,1437,383,185,568,64.85,79
Tofas Sahin: Online Car Driving,2023-02-15,41,125,57,182,64.79,2
It Lurks!,2023-01-18,2,5,1,6,64.78,0
Rue,2023-02-13,3,5,1,6,64.78,0
三千世界,2023-03-02,5,5,1,6,64.78,0
Xheres,2023-03-10,2,5,1,6,64.78,0
Nix: Ashes of the Phoenix,2023-03-24,3,5,1,6,64.78,0
Clockwork Survivors,2023-01-31,5,5,1,6,64.78,0
Radiant Cell,2023-01-10,2,5,1,6,64.78,0
Umbral Omen,2023-02-13,4,5,1,6,64.78,0
HAXWARE COMGAM,2023-01-31,6,5,1,6,64.78,0
Pushing POPO,2023-01-10,2,5,1,6,64.78,0
The Beastmaster Princess,2023-03-01,7,5,1,6,64.78,1
Demon's Wrath,2023-03-25,4,5,1,6,64.78,0
Paper Needs Inspiration!,2023-02-28,5,5,1,6,64.78,2
Full Moon Kit,2023-02-07,3,5,1,6,64.78,0
Fateel,2023-01-20,3,5,1,6,64.78,0
Terrarium Builder,2023-02-17,3,5,1,6,64.78,0
Cubis,2023-02-01,5,5,1,6,64.78,0
勇者起源,2023-01-16,2,5,1,6,64.78,0
Strip 4: Detention Bounce,2023-02-16,4,5,1,6,64.78,0
Metal Glove: Exodus,2023-02-17,2,5,1,6,64.78,0
Trapers Platformer,2023-01-12,3,5,1,6,64.78,0
Guacomole,2023-02-03,4,5,1,6,64.78,0
Myristica,2023-01-31,2,5,1,6,64.78,0
You Can Do!mino,2023-02-07,2,5,1,6,64.78,0
Battle of 2048 - Fantasy Edition,2023-02-01,2,5,1,6,64.78,0
Pyramis,2023-03-30,5,5,1,6,64.78,0
Donut Adventure,2023-03-20,2,5,1,6,64.78,0
Final Dose,2023-03-28,3,5,1,6,64.78,0
Hentai Cheerleader,2023-03-02,3,5,1,6,64.78,0
三国之旅,2023-04-07,24,5,1,6,64.78,4
NOT the Hero,2023-03-24,3,5,1,6,64.78,0
DragonStrike,2023-03-27,6,5,1,6,64.78,0
Darksy's Adventure,2023-03-31,6,5,1,6,64.78,0
Infinite Guitars,2023-03-30,18,10,3,13,64.76,0
Ghostly Moans,2023-03-06,8,10,3,13,64.76,0
Cloak & Dagger: Shadow Operations,2023-03-30,3,10,3,13,64.76,0
Goi,2023-03-14,49,10,3,13,64.76,0
Chess: The Lost Pieces,2023-01-31,8,10,3,13,64.76,1
Vosphia,2023-01-09,6,10,3,13,64.76,0
SlasherRPG,2023-01-07,6,10,3,13,64.76,0
フックと鎧獣,2023-04-07,14,10,3,13,64.76,0
JOIN tiles,2023-02-13,2,10,3,13,64.76,0
Furry Futa 💘,2023-03-31,4,10,3,13,64.76,0
Avoid It!,2023-03-24,5,10,3,13,64.76,0
Dirty Room,2023-03-24,15,10,3,13,64.76,2
Spooky Shelter,2023-03-20,3,10,3,13,64.76,0
7 Sins : Lost in Labyrinth,2023-02-10,15,26,10,36,64.73,0
黑棉花：悟能,2023-01-31,8,26,10,36,64.73,0
Deep Space Gardening,2023-02-13,12,17,6,23,64.73,0
Rally Car,2023-04-09,5,17,6,23,64.73,2
Prison Wars,2023-01-06,5,17,6,23,64.73,1
Prison Wars,2023-01-06,5,17,6,23,64.73,1
Prison Wars,2022-03-30,24,13,7,20,59.0,1
Prison Wars,2022-03-30,24,13,7,20,59.0,1
The Backrooms Experiment,2023-03-15,16,17,6,23,64.73,0
The Alchemist of Ars Magna,2023-03-31,45,17,6,23,64.73,7
Terminal Velocity™: Boosted Edition,2023-03-14,11,19,7,26,64.52,3
Yondu's Journey,2023-03-13,8,19,7,26,64.52,1
Click & Cum 💘💦,2023-03-01,123,72,32,104,64.49,2
Planet TD,2023-01-06,50,94,43,137,64.39,5
Glory of war,2023-03-17,85,98,45,143,64.38,9
Move Nature,2023-02-03,4,21,8,29,64.36,0
Hidden Mars,2023-02-10,4,12,4,16,64.35,0
Backroom Warfare II,2023-01-27,7,12,4,16,64.35,0
Interkosmos 2000,2023-02-16,5,12,4,16,64.35,0
JETT: The Far Shore + Given Time,2023-01-31,22,23,9,32,64.24,1
Tower Survivors,2023-02-28,11,23,9,32,64.24,1
Elle,2023-03-31,4,2,0,2,64.08,0
Unknown Ways,2023-03-27,0,2,0,2,64.08,
Techlie,2023-01-18,1,2,0,2,64.08,0
Skyratz,2023-01-02,7,2,0,2,64.08,0
Crosswalks,2023-03-31,2,2,0,2,64.08,0
Backbeat,2023-03-15,2,2,0,2,64.08,0
Warp Tango,2023-03-31,3,2,0,2,64.08,0
The Hero Journey in Yggdrasil,2023-03-18,3,2,0,2,64.08,0
Solomon Snow - First Contact,2023-04-01,3,2,0,2,64.08,0
Anyaroth: The Queen's Tyranny,2023-03-30,3,2,0,2,64.08,0
AsteRoid Rage,2023-03-31,1,2,0,2,64.08,0
Creature Hunter,2023-03-23,2,2,0,2,64.08,0
An Indie Game a Month: Unreal Journey,2023-03-07,4,2,0,2,64.08,0
Vacuum,2023-03-17,2,2,0,2,64.08,0
COVID_KILLER,2023-02-28,3,2,0,2,64.08,0
Anti-Bully Adventure,2023-02-28,1,2,0,2,64.08,0
A Weekend in Puzzleburg,2023-02-17,2,2,0,2,64.08,1
Natural Spirit,2023-01-30,2,2,0,2,64.08,0
Ski3,2023-02-14,2,2,0,2,64.08,0
Shenanigans,2023-02-24,5,2,0,2,64.08,0
Galactic Escape,2023-02-03,1,2,0,2,64.08,0
Hitstun,2023-03-22,4,2,0,2,64.08,0
The Killer,2023-02-03,1,2,0,2,64.08,0
Mega Demon Blaster,2023-04-04,2,2,0,2,64.08,0
YOW,2023-01-25,2,2,0,2,64.08,0
ball-e,2023-03-01,1,2,0,2,64.08,0
Wizard War VR,2023-02-26,2,2,0,2,64.08,0
Destroiders,2023-02-03,1,2,0,2,64.08,0
Ashcrown,2023-04-07,5,2,0,2,64.08,0
Heartbite: Dating by Daylight,2023-03-24,2,2,0,2,64.08,0
Binary.,2023-03-30,3,2,0,2,64.08,0
Walk with the Living 2,2023-01-13,2,2,0,2,64.08,0
Fleeting,2023-01-05,1,2,0,2,64.08,0
Adventures of Skye the Slime Maid,2023-04-07,2,2,0,2,64.08,0
Hilm,2023-04-30,3,2,0,2,64.08,0
Fisher's Qualm,2023-03-20,2,2,0,2,64.08,0
Ninja Scroller,2023-03-31,1,2,0,2,64.08,0
Voice of the Wizard by Brett Farkas,2023-01-05,1,2,0,2,64.08,0
Rebels - Under the Spell of Magic (Chapter 3),2023-02-26,2,2,0,2,64.08,0
Striker of Sky,2023-02-28,2,2,0,2,64.08,0
Around Us,2023-03-15,1,2,0,2,64.08,0
Flife,2023-01-01,6,2,0,2,64.08,0
DIMENSIONLESS,2023-03-15,1,2,0,2,64.08,0
Traveler,2023-01-15,3,2,0,2,64.08,0
Traveler,2023-01-15,3,2,0,2,64.08,0
Traveler,2021-12-11,4,7,0,7,73.26,0
Traveler,2021-12-11,4,7,0,7,73.26,0
The Widow's Boutique,2023-03-08,3,2,0,2,64.08,1
Keks Slot Machines,2023-03-12,2,2,0,2,64.08,1
The Dragon's Prophecy,2023-01-11,5,2,0,2,64.08,0
Nusantara,2023-03-31,1,2,0,2,64.08,0
Neko Dating Sim,2023-02-18,2,2,0,2,64.08,0
Wipe Factor,2023-02-08,10,2,0,2,64.08,0
Desktop Table Tennis,2023-04-03,2,2,0,2,64.08,0
EXTERMINATOR,2023-02-28,1,2,0,2,64.08,0
House of Jigsaw: Masters of Art,2023-03-23,2,2,0,2,64.08,0
Neopunk,2023-02-28,2,2,0,2,64.08,0
Cloud House,2023-03-31,2,2,0,2,64.08,0
Moorhuhn Pirates - Crazy Chicken Pirates,2023-03-02,3,2,0,2,64.08,0
7DAYS HEROES,2023-03-31,3,2,0,2,64.08,0
BulletLiveVR,2023-03-31,2,2,0,2,64.08,0
Crown of Thorns,2023-01-01,2,2,0,2,64.08,0
Olho,2023-02-04,1,2,0,2,64.08,0
Against All Odds,2023-02-23,4,2,0,2,64.08,1
Against All Odds,2023-02-23,4,2,0,2,64.08,0
Against All Odds,2022-12-04,2,3,0,3,67.06,1
Against All Odds,2022-12-04,2,3,0,3,67.06,0
Escape of Pig,2023-01-11,2,2,0,2,64.08,0
Just One,2023-01-23,1,2,0,2,64.08,0
Neon Blast,2023-02-16,2,2,0,2,64.08,0
Neon Blast,2023-02-16,2,2,0,2,64.08,0
Neon Blast,2019-04-15,3,2,0,2,64.08,0
Neon Blast,2019-04-15,3,2,0,2,64.08,0
Finding America: The Pacific Northwest,2023-01-30,3,2,0,2,64.08,0
Nature Escapes 2,2023-02-06,4,2,0,2,64.08,0
No13Shelter,2023-01-26,2,2,0,2,64.08,0
Tales Of Polygonia,2023-01-21,3,2,0,2,64.08,0
Water 2050,2023-03-16,2,2,0,2,64.08,0
Air Attack VR,2023-01-18,2,2,0,2,64.08,0
A Familiar World,2023-01-08,4,2,0,2,64.08,0
Farm in another world,2023-04-05,3,2,0,2,64.08,2
Lendas do Pebol: Mythic Football,2023-01-12,3,2,0,2,64.08,0
シンセティック・デイズ,2023-02-06,2,2,0,2,64.08,0
11 Years Ago,2023-02-24,4,2,0,2,64.08,0
Space landing,2023-01-14,1,2,0,2,64.08,0
Champ at Dawn,2023-01-23,2,2,0,2,64.08,0
Stella's Pointless Castle Awakening,2023-01-24,1,2,0,2,64.08,0
Glyph Guesser,2023-01-11,1,2,0,2,64.08,0
Seeking Asylum: The Game,2023-01-08,2,2,0,2,64.08,0
BOSSES,2023-01-02,2,2,0,2,64.08,0
The Great Artists,2023-01-09,1,2,0,2,64.08,0
Mutant Monty,2023-01-05,1,2,0,2,64.08,0
air star,2023-03-05,3,2,0,2,64.08,0
Grow Your Pets,2023-03-08,3,2,0,2,64.08,0
Grip on Reality,2023-02-19,1,2,0,2,64.08,0
Qdice,2023-01-21,2,2,0,2,64.08,0
The Sword That Kills Christmas,2023-01-09,3,2,0,2,64.08,0
Play football,2023-01-05,1,2,0,2,64.08,0
Gunslinger Nova,2023-01-17,2,2,0,2,64.08,0
Lichtreich: Willa,2023-01-10,2,2,0,2,64.08,0
SlimeCatcher,2023-02-08,1,2,0,2,64.08,0
Baalzebub,2023-03-31,1,2,0,2,64.08,0
BallZ,2023-01-17,2,2,0,2,64.08,0
Dummy Pirates: Ocean Tales,2023-04-01,3,2,0,2,64.08,0
Monsters Mess,2023-01-20,2,2,0,2,64.08,0
Waiter,2023-01-23,1,2,0,2,64.08,0
Light the Backrooms,2023-01-19,6,2,0,2,64.08,0
Vradark's Revenge,2023-01-26,1,2,0,2,64.08,0
Tedram,2023-01-27,2,2,0,2,64.08,0
Puzzle Pieces 4: Farewell Dear Winter,2023-02-23,1,2,0,2,64.08,0
CryptoZoo,2023-02-11,1,2,0,2,64.08,0
a land Goo's crazy,2023-03-25,2,2,0,2,64.08,1
DoDodge,2023-01-27,2,2,0,2,64.08,0
Archery Club,2023-03-20,3,2,0,2,64.08,0
Marshrutka,2023-02-09,1,2,0,2,64.08,0
視靈,2023-02-01,3,2,0,2,64.08,0
愛する妻が目の前で他人棒に貫かれ、よがり喘いでいく ～ゴメンなさいあなた。でも、私気持ちいいの…～,2023-04-06,1,2,0,2,64.08,0
他の男の精液で孕むとき ～襖の向こうで弟に精液を注ぎ込まれている妻～,2023-04-06,1,2,0,2,64.08,0
Disgusting Puzzle 2,2023-02-01,1,2,0,2,64.08,0
Omega Survivors,2023-02-03,2,2,0,2,64.08,0
Toast,2023-03-26,2,2,0,2,64.08,0
Targets,2023-02-12,2,2,0,2,64.08,0
Hill Climb,2023-02-06,2,2,0,2,64.08,0
Wonder Trips,2023-03-24,1,2,0,2,64.08,0
Jigsaw Puzzle Lovers,2023-02-08,2,2,0,2,64.08,0
Search,2023-03-31,2,2,0,2,64.08,0
Search,2023-03-31,2,2,0,2,64.08,0
Search,2022-08-28,2,9,7,16,53.59,0
Search,2022-08-28,2,9,7,16,53.59,0
Furry Armpits,2023-02-11,2,2,0,2,64.08,1
Police Car Armored: Cop Simulator,2023-02-14,2,2,0,2,64.08,0
Robot Room Cleaner,2023-02-10,3,2,0,2,64.08,0
OrbRider,2023-03-30,1,2,0,2,64.08,0
星空骑士,2023-03-14,1,2,0,2,64.08,0
Wars of Cards: ROMA,2023-03-24,6,2,0,2,64.08,0
BookyPets Legends,2023-03-30,1,2,0,2,64.08,0
恩索姆战士,2023-02-20,2,2,0,2,64.08,0
Wheelie King 5,2023-03-02,1,2,0,2,64.08,1
平凡的我與幽靈的同居生活,2023-02-27,3,2,0,2,64.08,0
When Sword Sinks Into Flowers,2023-02-20,2,2,0,2,64.08,0
SharkKing,2023-03-07,1,2,0,2,64.08,0
Pi Fu Fighter,2023-03-09,2,2,0,2,64.08,0
Evil Of Demons: Algailah,2023-04-06,2,2,0,2,64.08,0
災難探偵サイガ～名状しがたい怪事件～,2023-03-13,2,2,0,2,64.08,0
Mademoiselle Kshatriya,2023-03-01,1,2,0,2,64.08,0
Pandora,2023-03-10,4,2,0,2,64.08,0
Mahjong - Legacy of the Toltecs,2023-02-28,3,2,0,2,64.08,1
Vessel Blue,2023-04-11,5,2,0,2,64.08,0
Cyber Girl 1.1: REBOOT,2023-02-28,1,2,0,2,64.08,0
Hostile Dreams,2023-03-16,1,2,0,2,64.08,0
JetpacToo,2023-04-10,1,2,0,2,64.08,0
Endless Spaceship,2023-02-27,1,2,0,2,64.08,0
Poly Jigsaw: Cats,2023-02-21,4,2,0,2,64.08,0
Forbidden Dojo,2023-03-31,12,2,0,2,64.08,0
Cavimilation,2023-03-03,2,2,0,2,64.08,0
Hentai Casual Swap,2023-03-02,3,2,0,2,64.08,0
Odyssée numérique,2023-04-30,2,2,0,2,64.08,0
50 Rounds,2023-03-29,1,2,0,2,64.08,0
Escape the Unknown: Awaken the Realm,2023-04-04,3,2,0,2,64.08,0
Climber,2023-03-08,1,2,0,2,64.08,0
Hentai Senpai: Cyberpussy 2069,2023-03-24,4,2,0,2,64.08,0
Phantom Hunter,2023-03-31,3,2,0,2,64.08,1
Aqua Marbles - Ocean,2023-03-24,3,2,0,2,64.08,1
Mystery Case Files: The Dalimar Legacy Collector's Edition,2023-04-04,15,2,0,2,64.08,4
The Die Is Cast,2023-03-22,2,2,0,2,64.08,0
Battle Tanks: Arena,2023-03-17,1,2,0,2,64.08,0
Heart vs HP,2023-03-21,1,2,0,2,64.08,0
Wojak wants Hentai,2023-04-05,5,2,0,2,64.08,0
Car Delivery Man,2023-04-04,1,2,0,2,64.08,0
Train to Nowhere,2023-03-27,2,2,0,2,64.08,0
Shadow BoXR,2023-03-22,2,2,0,2,64.08,0
Fire Chat,2023-03-27,5,2,0,2,64.08,0
Ten Seconds Trillion,2023-03-21,5,2,0,2,64.08,0
Slingshot Battle,2023-03-23,2,2,0,2,64.08,0
Hollow Mission,2023-03-31,2,2,0,2,64.08,0
WITCH RACE Prologue,2023-03-24,5,2,0,2,64.08,0
Silver Box Classics,2023-03-27,8,2,0,2,64.08,0
Kings Love,2023-03-23,3,2,0,2,64.08,0
Scroter,2023-04-07,2,2,0,2,64.08,0
Amazing Trip to Europe,2023-03-21,3,2,0,2,64.08,1
Alien Planet Survival,2023-03-27,4,2,0,2,64.08,0
Ainmora: O Desastre Iminente,2023-03-29,4,2,0,2,64.08,0
Fateful Mages,2023-04-10,2,2,0,2,64.08,0
Boom Royale,2023-03-31,3,2,0,2,64.08,0
HEX PLAT,2023-03-31,1,2,0,2,64.08,0
Mars Colonization,2023-03-31,4,2,0,2,64.08,0
Tagger Mascot,2023-04-06,2,2,0,2,64.08,0
The Wingless Bee,2023-04-06,1,2,0,2,64.08,0
Cat Pipes,2023-04-10,2,2,0,2,64.08,0
Arcanika,2023-04-09,5,2,0,2,64.08,3
Anima Reprise,2023-06-30,1,2,0,2,64.08,0
PACTUM + EPISODE 1,2023-04-07,1,2,0,2,64.08,0
Somnus,2023-04-05,2,2,0,2,64.08,0
The madness of death,2023-01-25,8,14,5,19,64.07,0
Feudal Fantasy Incremental,2023-02-17,36,29,12,41,64.0,3
Redemption Reapers,2023-02-22,322,121,58,179,63.91,4
Bus Driving Sim 22,2023-02-02,36,152,74,226,63.89,3
Alien Egg: Ascent,2023-01-17,6,7,2,9,63.89,0
僵尸特攻队,2023-02-17,9,7,2,9,63.89,0
UnrealGundy,2023-03-31,3,7,2,9,63.89,0
Polaroid,2023-01-06,3,7,2,9,63.89,0
King's Hand,2023-01-20,6,7,2,9,63.89,0
Race in Desert,2023-01-06,3,7,2,9,63.89,0
Square garden,2023-01-31,3,7,2,9,63.89,0
House Sitter,2023-03-16,4,7,2,9,63.89,0
House Sitter,2023-03-16,4,7,2,9,63.89,0
House Sitter,2020-05-27,8,36,1,37,81.47,0
House Sitter,2020-05-27,8,36,1,37,81.47,0
Infinimine,2023-02-19,35,18,7,25,63.75,2
九州谕,2023-01-06,30,18,7,25,63.75,2
DOOMSDAY SURVIVORS,2023-03-10,13,18,7,25,63.75,0
Mysterious School,2023-02-17,822,154,76,230,63.66,1
EDEN: Create World,2023-03-01,6,20,8,28,63.65,0
Monster Battle,2023-03-15,8,20,8,28,63.65,0
Cooperative Chess,2023-02-16,16,22,9,31,63.58,2
Stay Out Of The Farm: Prologue,2023-02-23,5,22,9,31,63.58,0
Battle Team,2023-01-20,7,24,10,34,63.53,0
Resoraki,2023-03-23,26,24,10,34,63.53,2
Moving in with My Step-sister,2023-02-07,108,97,47,144,63.48,3
Omen of Sorrow,2023-03-23,11,9,3,12,63.45,1
Sushi Bar Express,2023-03-23,4,9,3,12,63.45,0
Powers of Hex,2023-04-06,3,9,3,12,63.45,0
Speed Dates,2023-03-31,3,9,3,12,63.45,0
Under the Sky World~Another~,2023-02-07,3,9,3,12,63.45,0
Echo Storm,2023-03-16,8,9,3,12,63.45,0
Into the Wonderland,2023-02-17,7,9,3,12,63.45,0
Lawnmower Game: Zombies,2023-03-06,3,9,3,12,63.45,0
Warehouse Simulator: Forklift Driver,2023-02-11,9,30,13,43,63.44,0
Negative Atmosphere: Emergency Room,2023-01-27,59,40,18,58,63.41,0
Nearly Dead - Live and Let Die,2023-02-24,62,38,17,55,63.41,0
Operation: Harsh Doorstop,2023-02-15,2074,3013,1657,4670,63.38,327
Pharaoh: A New Era,2023-02-15,6321,1655,901,2556,63.36,705
Handyman Corporation,2023-01-25,311,71,34,105,63.29,0
The Backrooms Game,2023-03-22,13,11,4,15,63.21,2
Idiotic The Game,2023-02-02,4,11,4,15,63.21,1
The Gravehouse,2023-01-06,4,11,4,15,63.21,1
School Flight Simulator,2023-02-13,4,11,4,15,63.21,0
Hank: Straightjacket,2023-02-01,4,11,4,15,63.21,0
SEX Room [18+],2023-02-04,329,101,50,151,63.17,0
Project: WATERFALL,2023-02-28,5,13,5,18,63.06,1
Stellar Sovereigns,2023-03-08,11,13,5,18,63.06,3
Futanari girls 3D ⚧👧🍆,2023-01-26,6,13,5,18,63.06,0
Errant Kingdom,2023-02-28,84,85,42,127,63.0,3
Dimensions: Dreadnought Architect,2023-02-02,149,81,40,121,62.95,1
Terfenstein 3D,2023-01-13,5,33,15,48,62.94,0
For Your Tranquility,2023-01-16,119,79,39,118,62.93,0
Dragon's Treasure,2023-03-25,4,17,7,24,62.93,0
Scary Turnaround,2023-01-28,3,17,7,24,62.93,0
The Guard,2023-02-28,4,17,7,24,62.93,0
绝影-Vanishing Shadow,2023-04-11,12,19,8,27,62.9,0
觅仙,2023-03-10,3290,328,175,503,62.87,5
Dominance,2023-01-12,484,197,103,300,62.86,4
Universe in Cum 💦 🌎,2023-03-25,76,129,66,195,62.86,4
I Am Your President,2023-02-27,370,99,50,149,62.8,12
大衍江湖,2023-02-11,324,445,243,688,62.63,2
苦主救助中心 Ⅲ,2023-03-11,560,427,234,661,62.53,2
Winter Survival: Prologue,2023-02-15,337,154,81,235,62.53,8
Getting Freaky With Fujiki,2023-04-07,6,4,1,5,62.51,0
A Sad Journey,2023-01-20,2,4,1,5,62.51,0
Running Robot Man 4,2023-02-07,4,4,1,5,62.51,0
Anica,2023-01-28,4,4,1,5,62.51,0
Frost League,2023-03-25,1,4,1,5,62.51,0
Alice in dreamland,2023-03-13,7,4,1,5,62.51,1
House of the Soul,2023-02-06,3,4,1,5,62.51,0
Pedigree Tactics,2023-01-06,3,4,1,5,62.51,0
Damoria,2023-02-24,14,4,1,5,62.51,0
KAKUDO,2023-03-30,3,4,1,5,62.51,0
Legacy,2023-02-03,4,4,1,5,62.51,0
BackRoomsNew,2023-01-03,3,4,1,5,62.51,1
Roadkill Raceway,2023-02-21,2,4,1,5,62.51,0
Dracula Defense!,2023-02-24,2,4,1,5,62.51,0
Don't Kill the Cat,2023-01-07,2,4,1,5,62.51,0
Cat Life,2023-01-06,3,4,1,5,62.51,0
Pepper Girl,2023-01-19,2,4,1,5,62.51,0
Horny Spell,2023-01-05,4,4,1,5,62.51,0
Yummy Girls 2,2023-01-31,1,4,1,5,62.51,0
流浪荒岛,2023-03-01,3,4,1,5,62.51,0
PunchMan Online,2023-03-24,6,4,1,5,62.51,0
Dragon Pinball,2023-03-03,2,4,1,5,62.51,1
Vlobs,2023-03-10,2,4,1,5,62.51,0
Christmas Night,2023-04-10,6,4,1,5,62.51,1
Survivor:Stay In The Light,2023-01-21,3,4,1,5,62.51,0
Horror Explus,2023-03-22,3,4,1,5,62.51,0
Goose Ronnie,2023-03-24,1,4,1,5,62.51,0
高考夺魁记,2023-02-08,7,4,1,5,62.51,0
FLUCTUOID,2023-02-28,4,4,1,5,62.51,0
Ghosting Vandal,2023-02-05,2,4,1,5,62.51,0
CARTOONITE,2023-03-03,4,4,1,5,62.51,0
Pato Martinez,2023-03-17,3,4,1,5,62.51,0
SomethingWithSpace,2023-02-18,2,4,1,5,62.51,0
Goblins,2023-03-18,3,4,1,5,62.51,0
OWLMAN,2023-02-24,3,4,1,5,62.51,1
Simple Increment,2023-03-02,16,4,1,5,62.51,5
ROBOCOCK,2023-03-29,2,4,1,5,62.51,0
Don't Rage,2023-04-08,4,4,1,5,62.51,0
Dodge It! Online,2023-01-24,21,30,14,44,62.4,1
Advanced Rogue Intelligence Assault: Genesis,2023-02-10,179,147,78,225,62.33,2
SEX LOVE & GIRLS❤️💦,2023-02-25,91,87,45,132,62.26,1
Caroline's Fantasies,2023-02-24,43,22,10,32,62.21,6
Bloodhound: First day in hell,2023-03-30,10,37,18,55,62.13,0
Exipelago,2023-01-10,5,6,2,8,62.1,0
Tomomon,2023-03-30,13,6,2,8,62.1,0
Extreme Tag!,2023-03-10,16,6,2,8,62.1,5
Asunder,2023-01-05,5,6,2,8,62.1,0
Citadelic,2023-02-17,7,6,2,8,62.1,0
The Cullfield Ritual,2023-01-05,2,6,2,8,62.1,0
Stick Bros,2023-01-26,10,6,2,8,62.1,1
Square Life,2023-01-29,5,6,2,8,62.1,0
Hand2Hand project,2023-02-12,5,6,2,8,62.1,0
Cat Jigsaw Puzzle Games,2023-03-06,5,6,2,8,62.1,0
VDSC Battle Royal,2023-03-30,63,6,2,8,62.1,0
OnlyFap Simulator 6 💦,2023-02-21,467,35,17,52,62.07,3
Stardust Exile,2023-02-17,19,16,7,23,62.05,1
M doll,2023-01-26,5,16,7,23,62.05,0
Hentai Hasshaku,2023-02-10,8,14,6,20,62.0,0
The Homecoming Exhibition,2023-03-05,4,14,6,20,62.0,0
The Nightmare Journey,2023-02-24,5,8,3,11,61.97,0
FPS Seduce - Hentai,2023-01-18,2,8,3,11,61.97,0
Formula Retro Racing - World Tour,2023-03-31,10,8,3,11,61.97,0
Lil Baby Poop's NIGHTMARES,2023-01-19,2,8,3,11,61.97,0
NoEL - Nothing on Elysion Line,2023-01-05,8,8,3,11,61.97,0
Agent Roy - Zombie Hunt,2023-01-26,1,8,3,11,61.97,0
Muscle MILF,2023-03-03,9,8,3,11,61.97,0
Elysium Heights,2023-03-23,6,8,3,11,61.97,0
Erin's Naughty Friday Prologue,2023-03-31,6,8,3,11,61.97,0
Who Run The City: Multiplayer,2023-02-10,13,10,4,14,61.95,0
CATACOMBS: The Beginning,2023-01-27,6,10,4,14,61.95,0
Berry Madness,2023-02-06,1,10,4,14,61.95,0
Dude Simulator 5,2023-03-10,4,10,4,14,61.95,1
Zombie Survivals [18+]🧟‍♀️🔞,2023-03-04,935,89,47,136,61.93,1
World Championship Boxing Manager™ 2,2023-01-17,39,29,14,43,61.86,1
Call of Duty®: Vanguard,2023-03-08,636,268,150,418,61.82,63
Tom Clancy's The Division 2,2023-01-12,11002,3335,1987,5322,61.71,"1,682"
Rune Break,2023-03-26,46,23,11,34,61.6,3
Ghost Recon Breakpoint,2023-01-23,9145,3204,1927,5131,61.49,"1,243"
Sweets Pusher Friends,2023-02-10,577,48,25,73,61.44,23
GameDev Life Simulator 🎮🕹,2023-02-18,165,58,31,89,61.25,2
Image,2023-01-20,4,17,8,25,61.25,0
Soulforged,2023-02-28,10,26,13,39,61.18,2
IamTheExorcist,2023-04-02,9,15,7,22,61.11,0
Garten of Banban 2,2023-03-03,1647,1141,692,1833,60.97,212
Cube Conflict,2023-02-15,19,13,6,19,60.95,0
Deceptus,2023-01-17,12,13,6,19,60.95,0
Fallen Bride Mege,2023-02-04,105,87,49,136,60.79,0
The Last World,2023-02-04,16,11,5,16,60.76,1
Hidden World 3 Top-Down 3D,2023-02-21,5,11,5,16,60.76,0
Fap & Cum 💦,2023-01-28,632,80,45,125,60.74,0
Fisherman's House,2023-01-07,4,20,10,30,60.74,0
Grand Theft Auto III - The Definitive Edition,2023-01-19,774,520,314,834,60.72,24
Ocean Punk,2023-01-12,19,32,17,49,60.59,0
TBTE - The Button Tycoon Experience,2023-01-05,93,9,4,13,60.54,0
Re:|THM - once upon a time,2023-02-09,8,16,8,24,60.34,1
The Third,2023-02-22,339,98,57,155,60.33,0
诡仙志异,2023-01-06,4,7,3,10,60.28,0
Tragedy of Medusa,2023-04-01,4,7,3,10,60.28,0
Hyper Shapes,2023-01-26,5,7,3,10,60.28,0
MULTIPLAYER KNIGHTS,2023-02-16,6,7,3,10,60.28,0
Quacktown Smackdown,2023-02-28,43,38,21,59,60.21,0
Warlander,2023-01-24,23428,3837,2454,6291,60.2,242
Warlander,2023-01-24,23428,3837,2454,6291,60.2,0
Warlander,2020-02-26,55,38,34,72,52.01,242
Warlander,2020-02-26,55,38,34,72,52.01,0
Nuclear War Simulator,2023-02-02,91,71,41,112,60.17,6
Project Hedra,2023-02-07,6,14,7,21,60.09,0
Korea Dynasty (조선메타실록),2023-01-15,50,82,48,130,60.06,8
Farmer's Father: Save the Innocence,2023-03-29,77,36,20,56,60.06,6
The Adventurer's Domain Online,2023-01-26,131,90,53,143,60.04,1
Frontiers Reach,2023-03-01,4,5,2,7,59.97,0
Sanctuary Saga,2023-03-08,14,5,2,7,59.97,0
Isaiah 188,2023-01-06,3,5,2,7,59.97,0
一九三零 浪漫譚,2023-03-29,7,5,2,7,59.97,0
Pantazil,2023-02-15,2,5,2,7,59.97,0
IN CELL,2023-01-12,1,5,2,7,59.97,0
Exorcist 2: Crow Magic,2023-01-05,3,5,2,7,59.97,1
Demonic Pack,2023-01-07,3,5,2,7,59.97,0
Anyone There?,2023-02-14,5,5,2,7,59.97,0
Gverse,2023-03-25,3,5,2,7,59.97,0
Mighty Mage,2023-02-01,2,5,2,7,59.97,0
Party Party Time,2023-01-12,5,5,2,7,59.97,0
Adventure with the Goddess,2023-01-19,5,5,2,7,59.97,0
No Way Out,2023-03-03,3,5,2,7,59.97,0
No Way Out,2023-03-03,3,5,2,7,59.97,4
No Way Out,2018-10-04,4601,42,63,105,42.46,0
No Way Out,2018-10-04,4601,42,63,105,42.46,4
PARANORMAL GIRLFRIEND,2023-02-27,2,5,2,7,59.97,0
Fatrifice,2023-03-20,3,5,2,7,59.97,0
Evil Superhero VR - Open-World Chaos,2023-03-26,3,5,2,7,59.97,0
THE ILLUSION: CURSE,2023-03-29,3,5,2,7,59.97,0
Sex with Succubus ❤️‍🔥,2023-02-08,281,81,48,129,59.84,5
Fast Burger Simulator,2023-01-09,4,12,6,18,59.8,0
Monster Tower Quest,2023-02-28,11,12,6,18,59.8,0
Hentai MagicalGirl,2023-02-17,5,12,6,18,59.8,0
INHUMAN,2023-01-11,35,53,31,84,59.66,0
Truck World: Driving School,2023-01-10,424,288,181,469,59.62,5
Elven Magic,2023-03-28,2,3,1,4,59.6,0
Bottle Journey,2023-01-05,2,3,1,4,59.6,0
Scrap Games,2023-01-17,2,3,1,4,59.6,0
Baldy Bounce,2023-02-13,3,3,1,4,59.6,0
Random Blacksmith Game,2023-02-19,2,3,1,4,59.6,0
On my own: A Hot Isekai Adventure,2023-01-13,6,3,1,4,59.6,0
ハラキリゲイシャガールズ！,2023-01-20,4,3,1,4,59.6,0
GPMoto Challenge,2023-04-07,3,3,1,4,59.6,0
Sherlock Holmes The Awakened,2023-04-11,723,3,1,4,59.6,314
Sovranti,2023-02-23,6,3,1,4,59.6,1
Paze Knight Ellen and the Dungeon town Sodom,2023-04-07,30,3,1,4,59.6,4
PolyRoyale,2023-03-01,2,3,1,4,59.6,0
The Kraken Wakes,2023-03-27,3,3,1,4,59.6,0
Zombie Prison Break,2023-02-10,2,3,1,4,59.6,0
Last Order,2023-02-17,5,3,1,4,59.6,0
无尽星海(Endless Stars),2023-01-17,3,3,1,4,59.6,0
Seven Wonders,2023-01-06,2,3,1,4,59.6,0
Cursed Angel: Time Paradox,2023-01-12,1,3,1,4,59.6,0
GameDev LiTuber Simulator,2023-02-15,3,3,1,4,59.6,0
The Final Bastion,2023-02-28,2,3,1,4,59.6,0
New Earth Saga of the New Gods,2023-03-03,7,3,1,4,59.6,0
Railways: Train Simulator,2023-03-29,5,3,1,4,59.6,0
The Entity Within,2023-02-28,2,3,1,4,59.6,0
Heralds of Silence,2023-03-08,2,3,1,4,59.6,0
Zero-G-Racer,2023-02-22,4,3,1,4,59.6,1
Redumption,2023-03-27,3,3,1,4,59.6,0
Ball Animals,2023-02-23,6,3,1,4,59.6,0
Eaten by Darkness,2023-04-02,2,3,1,4,59.6,0
Last Night in zombie village,2023-01-31,1,3,1,4,59.6,0
Unexpected Futa Corruption,2023-01-05,4,3,1,4,59.6,2
Stolen Wife ~Cucked On A Host Spring Company Trip~,2023-01-04,5,3,1,4,59.6,0
CGI™: The Game,2023-01-31,2,3,1,4,59.6,0
World Soccer Kid,2023-01-06,3,3,1,4,59.6,0
DiggerSim - Excavator & Heavy Equipment Simulator VR,2023-01-31,2,3,1,4,59.6,0
IOUA,2023-02-07,3,3,1,4,59.6,0
A Legend of Wisdom Part I,2023-01-23,2,3,1,4,59.6,0
Find the Whales,2023-01-12,2,3,1,4,59.6,0
Love Menu,2023-03-30,5,3,1,4,59.6,0
The Duck Song Game,2023-01-18,2,3,1,4,59.6,0
The Survivors,2023-02-24,2,3,1,4,59.6,0
塔尔战纪,2023-02-08,2,3,1,4,59.6,0
RPG Fitness VR,2023-01-27,2,3,1,4,59.6,1
Lilly's Flower Shop,2023-03-02,4,3,1,4,59.6,0
Midnight彌奈,2023-03-31,2,3,1,4,59.6,0
Little Land War SRPG,2023-02-14,1,3,1,4,59.6,0
À Travers Le Temps,2023-02-05,3,3,1,4,59.6,0
Street Boss,2023-02-28,4,3,1,4,59.6,0
Universe Survivors,2023-02-28,3,3,1,4,59.6,0
Web Crawlies {Multiplayer},2023-02-10,4,3,1,4,59.6,0
The Abyss,2023-02-16,2,3,1,4,59.6,0
Gangster City: Mafia Car Driving,2023-02-12,2,3,1,4,59.6,0
Special Courier,2023-02-27,3,3,1,4,59.6,0
Sex Simulator - The Yacht,2023-02-09,3,3,1,4,59.6,0
Blind and Schizophrenic,2023-03-31,3,3,1,4,59.6,0
Krakout,2023-02-28,3,3,1,4,59.6,0
Classic Car Simulator: Car Driving,2023-02-21,5,3,1,4,59.6,1
Mechafare,2023-03-10,2,3,1,4,59.6,0
Girls Tennis League,2023-03-31,3,3,1,4,59.6,0
Pporite,2023-03-17,5,3,1,4,59.6,0
I was born poor,2023-03-18,1,3,1,4,59.6,0
Twell,2023-03-21,4,3,1,4,59.6,0
The Last Of The Core,2023-03-27,1,3,1,4,59.6,0
GogMagog,2023-01-31,23,25,14,39,59.46,0
Forlorn,2023-03-01,5,10,5,15,59.43,0
Furry OwO,2023-01-20,5,10,5,15,59.43,0
Factorybelts 2,2023-02-27,2,1,0,1,59.42,0
OscarWildeCard,2023-03-03,1,1,0,1,59.42,0
Boom,2023-02-24,2,1,0,1,59.42,0
Boom,2023-02-24,2,1,0,1,59.42,0
Boom,2021-02-14,118,18,3,21,71.63,0
Boom,2021-02-14,118,18,3,21,71.63,0
Goblin Keep,2023-03-21,1,1,0,1,59.42,0
Torches of Fate,2023-04-06,2,1,0,1,59.42,1
Brain Tester : Mind trick quiz,2023-01-19,1,1,0,1,59.42,0
Operation: Harsh Doorstop - Development Build,2023-03-30,18,1,0,1,59.42,1
Kapow Pets,2023-03-09,1,1,0,1,59.42,0
Nefasto's Misadventure: Meeting Noeroze,2023-03-23,3,1,0,1,59.42,0
Base Jump,2023-02-13,2,1,0,1,59.42,0
VOLLEYGON,2023-02-17,1,1,0,1,59.42,0
卢沟桥事变,2023-01-27,1,1,0,1,59.42,0
Our Mother's house,2023-04-10,2,1,0,1,59.42,0
RoguekiniZ,2023-01-10,3,1,0,1,59.42,0
Three Adventures Imagined with Monsters - T.I.MO,2023-03-31,2,1,0,1,59.42,0
Core-Blast,2023-03-24,3,1,0,1,59.42,0
Biblios Dice,2023-01-30,4,1,0,1,59.42,0
Tear of Titans,2023-02-27,1,1,0,1,59.42,0
Knight Solitaire 2,2023-01-31,3,1,0,1,59.42,0
Zenteni,2023-02-01,2,1,0,1,59.42,0
Project Utgardr,2023-02-03,1,1,0,1,59.42,0
Hunter Project: Operation Survive,2023-04-08,1,1,0,1,59.42,0
The Original Wizard,2023-03-24,1,1,0,1,59.42,0
Best Of Eleven,2023-04-10,2,1,0,1,59.42,0
Death's Dungeon,2023-03-24,3,1,0,1,59.42,0
Mystery Solitaire. Grimm's Tales 7,2023-01-18,3,1,0,1,59.42,1
Playback Trauma: In Sickness,2023-01-26,2,1,0,1,59.42,0
Blickel,2023-01-13,2,1,0,1,59.42,0
Path of a Player 2,2023-01-26,2,1,0,1,59.42,0
Bullet Chase,2023-01-17,1,1,0,1,59.42,0
Adventures of DaKoo the Dragon,2023-03-29,2,1,0,1,59.42,0
Rally 9000,2023-03-30,2,1,0,1,59.42,0
The Game of Fourtune,2023-04-04,10,1,0,1,59.42,2
1001 Jigsaw. Cute Cats 3,2023-01-20,1,1,0,1,59.42,0
Protocol Aftertime,2023-04-11,2,1,0,1,59.42,0
Living Legends Remastered: Wrath of the Beast Collector's Edition,2023-03-10,7,1,0,1,59.42,0
Bakeborough,2023-03-28,4,1,0,1,59.42,0
SoleSurvivor,2023-04-03,3,1,0,1,59.42,0
Those Left Behind,2023-03-20,1,1,0,1,59.42,0
Dyestributor,2023-01-13,4,1,0,1,59.42,0
ATCo2,2023-03-09,2,1,0,1,59.42,0
Depois da chuva de meteoros,2023-01-08,1,1,0,1,59.42,0
The Prowler Hell,2023-04-07,3,1,0,1,59.42,0
Deltatile,2023-03-31,2,1,0,1,59.42,0
Lollypop,2023-01-06,2,1,0,1,59.42,0
Wander Vyrosa,2023-03-16,4,1,0,1,59.42,0
创业大亨,2023-03-24,4,1,0,1,59.42,0
Atham Battle Simulator,2023-03-24,1,1,0,1,59.42,0
Elven Rivers: The Forgotten Lands Collector's Edition,2023-03-03,5,1,0,1,59.42,0
Meta Lines,2023-04-04,4,1,0,1,59.42,1
ニンニン☆妖怪大戦争,2023-03-09,12,1,0,1,59.42,0
Super Mando,2023-01-27,1,1,0,1,59.42,0
Scientifically Accurate Dinosaur Mating Simulator 2022: American Revolution 1775 - 1786,2023-01-03,1,1,0,1,59.42,0
Witch Guild Survivor,2023-02-15,3,1,0,1,59.42,0
FukTopia 5,2023-01-30,1,1,0,1,59.42,0
That Makes Sense,2023-02-17,1,1,0,1,59.42,0
Sky traveler,2023-02-28,1,1,0,1,59.42,0
Forgotten Souls,2023-04-03,8,1,0,1,59.42,0
Forgotten Souls,2023-04-03,8,1,0,1,59.42,0
Forgotten Souls,2021-11-19,5,10,3,13,64.76,0
Forgotten Souls,2021-11-19,5,10,3,13,64.76,0
Boing,2023-01-19,1,1,0,1,59.42,0
Nuclear Arena,2023-01-15,3,1,0,1,59.42,0
Video Game Trivia,2023-02-25,2,1,0,1,59.42,0
Celebrity Slot Machine,2023-04-06,1,1,0,1,59.42,0
Lucky Slots,2023-04-06,2,1,0,1,59.42,0
STARLITE: Defender of Justice Ultimate HD Edition,2023-01-22,1,1,0,1,59.42,0
VOID,2023-03-15,1,1,0,1,59.42,0
VOID,2023-03-15,1,1,0,1,59.42,0
VOID,2023-03-15,1,1,0,1,59.42,0
VOID,2023-03-15,1,1,0,1,59.42,0
VOID,2022-11-07,30,15,8,23,59.37,0
VOID,2022-11-07,30,15,8,23,59.37,0
VOID,2022-11-07,30,15,8,23,59.37,0
VOID,2022-11-07,30,15,8,23,59.37,0
VOID,2018-11-28,2,5,2,7,59.97,0
VOID,2018-11-28,2,5,2,7,59.97,0
VOID,2018-11-28,2,5,2,7,59.97,0
VOID,2018-11-28,2,5,2,7,59.97,0
VOID,2017-10-31,7,28,8,36,68.41,0
VOID,2017-10-31,7,28,8,36,68.41,0
VOID,2017-10-31,7,28,8,36,68.41,0
VOID,2017-10-31,7,28,8,36,68.41,0
Red Sea,2023-03-13,1,1,0,1,59.42,0
Desktop Bowling,2023-04-03,2,1,0,1,59.42,0
Our Summer Sports,2023-02-02,2,1,0,1,59.42,0
Bat Hero,2023-03-08,1,1,0,1,59.42,0
Takenoko - Tilt Five AR,2023-02-28,2,1,0,1,59.42,0
Millie and Molly,2023-01-23,2,1,0,1,59.42,0
Escape From School,2023-01-06,2,1,0,1,59.42,0
Escape From School,2023-01-06,2,1,0,1,59.42,6
Escape From School,2021-09-07,51,360,145,505,68.02,0
Escape From School,2021-09-07,51,360,145,505,68.02,6
Adventure's Pixel World,2023-01-16,2,1,0,1,59.42,0
How long can you survive,2023-02-21,2,1,0,1,59.42,0
THGITW,2023-03-08,2,1,0,1,59.42,0
TROJAN,2023-02-07,2,1,0,1,59.42,0
Super Uriel,2023-03-27,1,1,0,1,59.42,0
VetVR,2023-03-06,3,1,0,1,59.42,0
Vampire Tourist,2023-01-06,1,1,0,1,59.42,0
Soul Taker,2023-02-16,2,1,0,1,59.42,0
Breu: Shadow Hunt,2023-01-27,1,1,0,1,59.42,0
Stream Runners: Heroes,2023-02-02,3,1,0,1,59.42,0
Off The Tracks,2023-03-17,2,1,0,1,59.42,0
Monster Hide,2023-04-04,11,1,0,1,59.42,0
0xFF,2023-03-28,1,1,0,1,59.42,0
String Along,2023-01-17,2,1,0,1,59.42,0
Laruaville 4,2023-01-08,6,1,0,1,59.42,0
Hot 21,2023-02-17,4,1,0,1,59.42,0
Tiny Troopers: Joint Ops XL,2023-03-09,4,1,0,1,59.42,0
Royale Battle: Warzone,2023-01-06,2,1,0,1,59.42,0
Unlimited Fight Ultimate Strike,2023-03-30,1,1,0,1,59.42,0
The Rocket Jumper,2023-01-27,2,1,0,1,59.42,0
Beach Cafe: Caribbean Sand,2023-01-20,3,1,0,1,59.42,0
KARAKURI KENGEKI,2023-01-08,1,1,0,1,59.42,0
Temple and Secrets,2023-02-10,1,1,0,1,59.42,0
The Big One,2023-02-28,2,1,0,1,59.42,0
Vengeful Castle,2023-02-27,2,1,0,1,59.42,0
JLGJ,2023-01-05,2,1,0,1,59.42,0
Project Sail,2023-01-13,2,1,0,1,59.42,0
Elves Castle and Secrets,2023-02-12,2,1,0,1,59.42,0
Medieval and Secrets,2023-02-10,2,1,0,1,59.42,0
Mouse Dreams,2023-01-03,1,1,0,1,59.42,0
Gravlist,2023-02-05,1,1,0,1,59.42,0
Summer Village,2023-01-03,2,1,0,1,59.42,0
The Fisherman and the Sea,2023-03-31,2,1,0,1,59.42,0
Nautikin Adventures,2023-03-31,5,1,0,1,59.42,0
回响之战,2023-02-03,2,1,0,1,59.42,0
Snake Robot,2023-01-22,1,1,0,1,59.42,0
Halves,2023-02-22,1,1,0,1,59.42,0
Hightail,2023-03-01,1,1,0,1,59.42,0
Johny Explorer,2023-01-13,1,1,0,1,59.42,0
Defending Earth,2023-02-21,1,1,0,1,59.42,0
Up To Clouds,2023-03-07,2,1,0,1,59.42,0
The Space Bar,2023-03-31,3,1,0,1,59.42,0
汐留TrainSimulator,2023-01-31,2,1,0,1,59.42,0
Neptune's Garden,2023-01-13,1,1,0,1,59.42,0
Beat animals,2023-01-05,2,1,0,1,59.42,0
PIP D,2023-01-03,2,1,0,1,59.42,0
Fiendish Freddy's Big Top O' Fun,2023-03-31,1,1,0,1,59.42,0
PINHI!,2023-01-08,1,1,0,1,59.42,0
Ball vs Zombie,2023-03-01,3,1,0,1,59.42,0
Delirium,2023-02-02,3,1,0,1,59.42,0
Delirium,2023-02-02,3,1,0,1,59.42,0
Delirium,2023-02-02,3,1,0,1,59.42,0
Delirium,2020-04-14,2,2,1,3,55.69,0
Delirium,2020-04-14,2,2,1,3,55.69,0
Delirium,2020-04-14,2,2,1,3,55.69,0
Delirium,2017-08-31,136,11,9,20,53.0,0
Delirium,2017-08-31,136,11,9,20,53.0,0
Delirium,2017-08-31,136,11,9,20,53.0,0
Training Shooter FPS,2023-01-20,2,1,0,1,59.42,0
white water,2023-01-16,1,1,0,1,59.42,0
BoxLoop 2,2023-01-19,1,1,0,1,59.42,0
Epic Race: The Stadium,2023-01-17,1,1,0,1,59.42,0
一个人的木偶剧,2023-02-07,2,1,0,1,59.42,0
Deep In The Snowy Night,2023-01-20,2,1,0,1,59.42,0
Touch the Color,2023-01-20,1,1,0,1,59.42,0
Traffic Brains 2,2023-03-31,3,1,0,1,59.42,0
FULLYBROKEN: WAY HOME,2023-01-16,1,1,0,1,59.42,0
草食系男子の言いなり入院生活- A passive boy at the Huntress clinic -,2023-01-27,2,1,0,1,59.42,0
Drop It: Block Paradise!,2023-02-13,3,1,0,1,59.42,0
Slippery Flippers,2023-02-02,1,1,0,1,59.42,0
病菌幸存者,2023-04-07,1,1,0,1,59.42,0
键盘侠Keyboardmen,2023-01-24,1,1,0,1,59.42,0
Sudoku Vacation,2023-02-16,2,1,0,1,59.42,0
Quadice,2023-02-01,1,1,0,1,59.42,0
沙盘战火调度,2023-01-24,2,1,0,1,59.42,0
Adventurer Flower,2023-01-27,2,1,0,1,59.42,0
Sky High Games Horror Collection,2023-02-15,1,1,0,1,59.42,0
Cookie Match: Enhanced Edition,2023-01-19,2,1,0,1,59.42,0
Grim Tales: The Time Traveler Collector's Edition,2023-01-13,7,1,0,1,59.42,0
Poly Puzzle: Butterflies,2023-01-21,3,1,0,1,59.42,0
Vacation Adventures: Park Ranger 14 Collector's Edition,2023-01-26,3,1,0,1,59.42,0
Bottoms Up!: Part 1,2023-04-07,2,1,0,1,59.42,0
Beat The Soul Z,2023-02-19,2,1,0,1,59.42,0
Rope Bowling,2023-02-01,1,1,0,1,59.42,0
Wizard Hentai Survivors,2023-02-01,3,1,0,1,59.42,0
EscapeGame TimelessRoom,2023-02-01,1,1,0,1,59.42,0
Jump Tale,2023-02-15,1,1,0,1,59.42,0
Haunting of the Evil Spirit - Horror Choose your own adventure Novel,2023-01-27,1,1,0,1,59.42,0
Carta Nostra,2023-02-01,4,1,0,1,59.42,0
AquaHero,2023-02-17,1,1,0,1,59.42,0
Fairytale Theatre,2023-03-02,1,1,0,1,59.42,0
ソウエンノイセキ,2023-02-03,4,1,0,1,59.42,0
TAL: Arctic 5,2023-02-09,3,1,0,1,59.42,0
Hexield,2023-02-04,1,1,0,1,59.42,0
Ancient Guardians: The Dragon,2023-02-06,3,1,0,1,59.42,0
The MisAdventures of Xenos,2023-03-20,2,1,0,1,59.42,0
愛する妻、玲奈の浮気告白 『お、俺より気持ち良かったのか…？』→『…うん。凄かった』,2023-04-06,1,1,0,1,59.42,0
Sudoku Classic,2023-02-24,4,1,0,1,59.42,1
Dark Traveller,2023-03-16,2,1,0,1,59.42,0
Sigformation,2023-02-10,2,1,0,1,59.42,0
Halloween in Hollywood,2023-02-03,2,1,0,1,59.42,0
It Happened Here: Streaming Lives Collector's Edition,2023-02-10,5,1,0,1,59.42,0
Frogvival,2023-03-06,2,1,0,1,59.42,0
MoonScavenger,2023-03-02,2,1,0,1,59.42,0
Buggy,2023-02-14,2,1,0,1,59.42,0
Buggy,2023-02-14,2,1,0,1,59.42,0
Buggy,2015-07-06,3,13,6,19,60.95,0
Buggy,2015-07-06,3,13,6,19,60.95,0
Doodle TD,2023-02-28,2,1,0,1,59.42,0
Checkerboard Collection,2023-02-09,3,1,0,1,59.42,0
The Last Pawn,2023-02-16,1,1,0,1,59.42,0
Let's go back to our village,2023-02-14,2,1,0,1,59.42,0
My sister-in-law won't let go of my cock ~Seduced by a widowed proprietress~,2023-03-17,1,1,0,1,59.42,0
Sector 598,2023-02-10,1,1,0,1,59.42,0
De Feet,2023-02-16,2,1,0,1,59.42,0
The Hero's Journey through Time,2023-02-20,2,1,0,1,59.42,0
CODING ROBO,2023-03-21,1,1,0,1,59.42,0
Twerk it Girl!,2023-02-24,2,1,0,1,59.42,0
Labyrinthian: Lost 'Til Dawn,2023-02-17,1,1,0,1,59.42,0
Everyone's Happy Place,2023-02-28,2,1,0,1,59.42,0
Cube Roller,2023-03-31,2,1,0,1,59.42,0
The Dragon Queen,2023-03-23,2,1,0,1,59.42,0
ZOMBIE HUNTER -FACE THE SINS-,2023-02-22,2,1,0,1,59.42,0
Magnetik,2023-02-21,1,1,0,1,59.42,0
Jack the Nipper II,2023-02-28,1,1,0,1,59.42,0
Photon Engineer,2023-04-10,2,1,0,1,59.42,0
Offroad Jeep 4x4: Car Driving Simulator,2023-02-22,2,1,0,1,59.42,0
Parcel Problems,2023-02-28,1,1,0,1,59.42,0
Bedrock High,2023-03-10,1,1,0,1,59.42,0
Sinful soul club,2023-04-08,4,1,0,1,59.42,0
Fight With Keys,2023-02-28,1,1,0,1,59.42,0
蒂羅森紫花詠Tirosens thistle-中文版-,2023-02-28,2,1,0,1,59.42,0
Shadow of the Night,2023-02-20,2,1,0,1,59.42,0
Dead eat dead,2023-02-22,2,1,0,1,59.42,0
8-Ball Pocket,2023-03-03,2,1,0,1,59.42,0
The Last Hero,2023-03-27,1,1,0,1,59.42,0
SpiderAttack,2023-02-21,1,1,0,1,59.42,0
Pop Some Eyes,2023-03-31,2,1,0,1,59.42,0
Trans Agent X,2023-03-30,2,1,0,1,59.42,0
Fishjong 2,2023-04-02,2,1,0,1,59.42,0
KitBashers 2 [Multiplayer],2023-02-23,3,1,0,1,59.42,0
Fox Girl Taming,2023-03-31,4,1,0,1,59.42,0
Fabulous Field Trip,2023-03-07,1,1,0,1,59.42,0
Knight Cats: Leaves on the Road Collector's Edition,2023-02-17,5,1,0,1,59.42,0
Architecture Zeitgeist,2023-03-27,2,1,0,1,59.42,0
Retro Style - Pixel Art Jigsaw Puzzles,2023-02-27,1,1,0,1,59.42,0
Adrenaline Dungeon,2023-03-30,2,1,0,1,59.42,0
1000 Man General,2023-03-28,2,1,0,1,59.42,0
AgrChamp,2023-03-10,2,1,0,1,59.42,0
MoonLess,2023-04-05,1,1,0,1,59.42,0
Starblast: 3D Wars,2023-04-06,2,1,0,1,59.42,0
Crossroad of Worlds: Mirrors to Other worlds Collector's Edition,2023-03-07,1,1,0,1,59.42,0
俺たち対空兵,2023-03-10,2,1,0,1,59.42,0
Project Dark,2023-04-06,3,1,0,1,59.42,0
Shelltered,2023-03-07,1,1,0,1,59.42,0
Lattice Dancer,2023-03-08,1,1,0,1,59.42,0
FOBIA ...worse than fear.,2023-03-24,3,1,0,1,59.42,0
Dune of the Desert,2023-03-21,2,1,0,1,59.42,0
Deeper In The Dark,2023-03-10,1,1,0,1,59.42,0
chi_ninja,2023-03-17,1,1,0,1,59.42,0
GHOST HUNTER,2023-03-21,1,1,0,1,59.42,1
Aniballs,2023-03-14,2,1,0,1,59.42,0
AntiVirus_snake,2023-03-10,2,1,0,1,59.42,0
Undead zone,2023-03-31,1,1,0,1,59.42,0
Bridge to Another World: Cursed Clouds,2023-02-28,9,1,0,1,59.42,0
Shepherd,2023-03-17,3,1,0,1,59.42,0
SEARCH ALL - FRUITS,2023-03-16,4,1,0,1,59.42,0
HandleIT,2023-03-31,1,1,0,1,59.42,0
Volar,2023-03-22,3,1,0,1,59.42,0
Simple Arcade,2023-03-20,1,1,0,1,59.42,0
Poly Jigsaw: Birds,2023-03-11,2,1,0,1,59.42,0
Super Passport Bros,2023-03-27,0,1,0,1,59.42,
GUARDIAN OF DYNAMITE : A BOMB PROTECTOR,2023-03-28,2,1,0,1,59.42,0
Amazo,2023-03-27,1,1,0,1,59.42,0
VIRA,2023-04-10,1,1,0,1,59.42,0
Manic Archers - Bullseye DEMO,2023-03-29,1,1,0,1,59.42,0
Jump Jump Cyberpunk,2023-03-30,2,1,0,1,59.42,0
Our Summer Festival,2023-04-03,4,1,0,1,59.42,0
Farm Day 2023,2023-03-21,5,1,0,1,59.42,2
Ascendant's Roguelike,2023-03-27,2,1,0,1,59.42,0
The Viriditas Chapel of Perpetual Adoration,2023-03-13,1,1,0,1,59.42,0
车辆对战僵尸 Vehicle Beat Zombie,2023-03-31,1,1,0,1,59.42,0
Bye Bye Swingby,2023-04-03,2,1,0,1,59.42,0
Executioner Girls,2023-04-06,3,1,0,1,59.42,0
Ferb,2023-03-31,1,1,0,1,59.42,0
Robot Lawn Mower,2023-03-31,2,1,0,1,59.42,0
Getting To The Other Side!!!,2023-04-08,1,1,0,1,59.42,0
Crossroads: Escaping the Dark,2023-03-20,5,1,0,1,59.42,0
异界旅客：序章,2023-04-06,3,1,0,1,59.42,0
Fireball Spam,2023-04-04,1,1,0,1,59.42,0
Greymarsh,2023-04-07,2,1,0,1,59.42,0
That Rocket Game,2023-04-11,5,1,0,1,59.42,0
GALAHAD 3093,2023-01-24,62,95,59,154,59.13,5
Chinese Rail SIm,2023-02-10,30,18,10,28,59.1,0
PRIMITIVE HEARTS,2023-02-18,121,34,20,54,59.08,0
The Hidden and Unknown,2023-01-23,2,13,7,20,59.0,0
My Neighbor Neko,2023-01-27,4,13,7,20,59.0,0
Orders Of The Ruler,2023-03-27,2,8,4,12,58.97,0
Fear of the Dark,2023-02-17,6,8,4,12,58.97,0
The Summon,2023-04-04,17,8,4,12,58.97,1
Painter Simulator,2023-03-02,15,8,4,12,58.97,0
Code Red,2023-01-20,9,8,4,12,58.97,0
Hike Isle,2023-01-13,3,8,4,12,58.97,0
SUBNET,2023-02-09,8,8,4,12,58.97,0
LEAP,2023-03-01,371,209,135,344,58.9,1
The Palace of Unrest,2023-01-18,52,49,30,79,58.81,0
Best in the West,2023-01-22,50,79,50,129,58.64,0
Secret Of Dungeon,2023-02-25,20,11,6,17,58.55,0
Crime Scene,2023-01-20,2,11,6,17,58.55,0
Hidden Post-Apocalyptic 4 Top-Down 3D,2023-01-25,2,11,6,17,58.55,0
ENDLESS,2023-03-24,9,11,6,17,58.55,0
Random Chat,2023-03-28,131,39,24,63,58.5,5
Hide & Chick,2023-03-01,68,22,13,35,58.49,0
Estencel,2023-01-19,24,31,19,50,58.33,0
Yeah！Fighting Girl,2023-01-11,12,14,8,22,58.33,0
Liminal Reality,2023-02-15,3,14,8,22,58.33,0
Mangavania,2023-01-20,5,6,3,9,58.33,0
Mafia Clicker: City Builder,2023-03-16,9,6,3,9,58.33,1
Jylko: Through The Song,2023-04-07,3,6,3,9,58.33,0
The Past,2023-01-06,1,6,3,9,58.33,0
Hike Trip,2023-01-27,2,6,3,9,58.33,0
Eggsplorer,2023-03-30,5,6,3,9,58.33,1
PlanetSprite,2023-03-23,7,6,3,9,58.33,2
League Manager 2023,2023-03-16,30,55,35,90,58.25,13
Revans,2023-01-12,9,20,12,32,58.14,0
Karagon,2023-02-13,126,41,26,67,58.05,2
Summer Daze: Tilly's Tale,2023-03-28,7,9,5,14,57.96,1
World Annihilation Operations Parts I-IV,2023-02-14,2,9,5,14,57.96,0
Death Swap: End As One,2023-01-25,39,70,46,116,57.88,0
Faith & Shield:4044 Tower Defense,2023-01-06,5,12,7,19,57.82,0
Xuan-Yuan Sword V,2023-01-12,62,36,23,59,57.8,2
Desolation,2023-03-17,8,15,9,24,57.76,0
WuJiDaoRen,2023-03-13,43,40,26,66,57.61,4
Ancient Cities,2023-03-24,549,659,466,1125,57.54,86
Sun Down,2023-02-25,46,34,22,56,57.54,1
1971: Indian Naval Front,2023-04-05,7,4,2,6,57.39,0
Lost Empire 2977,2023-01-11,4,4,2,6,57.39,0
Castle: Daybreak,2023-01-01,4,4,2,6,57.39,0
Gigantosaurus: Dino Kart,2023-02-17,4,4,2,6,57.39,0
Hohenheim: Skywards,2023-01-03,2,4,2,6,57.39,0
Pentacore,2023-02-11,3,4,2,6,57.39,0
Ember's Love,2023-02-24,4,4,2,6,57.39,0
Tribu,2023-01-06,4,4,2,6,57.39,0
VRrOOm,2023-02-03,4,4,2,6,57.39,0
Sex-Loving Family,2023-03-30,15,4,2,6,57.39,0
Dungeon Shooter : Dark Temple,2023-02-03,3,4,2,6,57.39,0
Snowball Christmas festival,2023-03-22,4,4,2,6,57.39,0
Demon Hentai Slayer,2023-03-18,3,4,2,6,57.39,0
Dangerous Road,2023-03-31,7,4,2,6,57.39,1
OVE : The Sword of Liberation,2023-02-17,5,4,2,6,57.39,0
Heavy Armored Assassin,2023-03-20,3,4,2,6,57.39,0
VONA / She,2023-03-13,3,4,2,6,57.39,0
SimPoly Drive,2023-03-30,2,4,2,6,57.39,0
Hentai Melody,2023-04-06,3,4,2,6,57.39,0
Forspoken,2023-01-24,12579,3466,2527,5993,57.26,144
Bram The Toymaker,2023-01-20,6,16,10,26,57.26,0
NecroCity,2023-04-05,90,16,10,26,57.26,2
Risnuch,2023-02-20,8,13,8,21,57.21,0
Royal Merchant,2023-02-26,18,29,19,48,57.19,1
Avernus,2023-01-20,8,7,4,11,57.18,0
Hacker's Restart,2023-03-01,26,7,4,11,57.18,0
Pain Cage Tournament,2023-02-24,5,7,4,11,57.18,0
Paranoia Party,2023-02-11,11,7,4,11,57.18,0
Cat Boy Creator,2023-02-24,3,7,4,11,57.18,0
Spicy Strip Poker,2023-02-15,12,10,6,16,57.17,0
Etherion Online,2023-03-10,191,36,24,60,57.1,17
Sands,2023-03-07,57,30,20,50,56.94,0
Puzzle Bobble™2X/BUST-A-MOVE™2 Arcade Edition & Puzzle Bobble™3/BUST-A-MOVE™3 S-Tribute,2023-02-01,17,14,9,23,56.69,0
UNRESTRAINED,2023-01-13,6,14,9,23,56.69,0
Royal Booty Quest,2023-02-24,102,57,40,97,56.56,0
Spring X Elixir,2023-02-13,8,11,7,18,56.53,0
You Are Sick,2023-03-10,5,11,7,18,56.53,0
Ephesus,2023-02-17,17,54,38,92,56.47,0
情人泪,2023-01-24,59,40,28,68,56.36,0
Angels on Tanks,2023-02-24,7,8,5,13,56.32,0
Word Crystal,2023-01-16,5,8,5,13,56.32,0
Clay Soldiers,2023-02-10,5,8,5,13,56.32,0
Kinky Cosplay: Gyarus Gone Wild,2023-01-13,13,8,5,13,56.32,0
The Last Saintess,2023-04-10,26,8,5,13,56.32,15
SmallZ,2023-01-10,7,19,13,32,56.1,0
Survivors: Three Kingdoms,2023-03-23,38,38,27,65,56.06,6
Company of Heroes 3,2023-02-23,36646,8508,6576,15084,56.05,"6,139"
Space Pirate King,2023-03-10,4,5,3,8,56.05,0
A Modest Legacy,2023-01-23,8,5,3,8,56.05,0
Building Destruction,2023-01-28,5,5,3,8,56.05,0
ROGLE,2023-01-31,2,5,3,8,56.05,0
Polygone,2023-03-21,4,5,3,8,56.05,0
Polygone,2023-03-21,4,5,3,8,56.05,0
Polygone,2018-10-05,2,5,1,6,64.78,0
Polygone,2018-10-05,2,5,1,6,64.78,0
Snow Mountain,2023-02-24,1,5,3,8,56.05,0
Scavenger,2023-03-26,5,5,3,8,56.05,0
Scavenger,2023-03-26,5,5,3,8,56.05,0
Scavenger,2017-10-13,4,5,1,6,64.78,0
Scavenger,2017-10-13,4,5,1,6,64.78,0
ApplePop,2023-03-10,2,5,3,8,56.05,0
Mechanical Survivor,2023-03-20,18,5,3,8,56.05,1
Aconite,2023-02-10,4,12,8,20,56.0,0
ARTificial,2023-02-27,18,12,8,20,56.0,0
Osiris: New Dawn,2023-01-18,4773,8116,6310,14426,55.91,74
Rendezvous,2023-04-11,9,2,1,3,55.69,1
Surprising My Neighbors 2,2023-03-01,3,2,1,3,55.69,0
Rogue Sweeper,2023-03-07,6,2,1,3,55.69,0
Seance,2023-03-13,3,2,1,3,55.69,0
Seance,2023-03-13,3,2,1,3,55.69,0
Seance,2021-05-28,6,62,4,66,81.55,0
Seance,2021-05-28,6,62,4,66,81.55,0
United Assault - World War 2,2023-03-30,5,2,1,3,55.69,0
TruXposure VR,2023-03-08,2,2,1,3,55.69,0
The Secret Ops ,2023-01-22,2,2,1,3,55.69,0
Upgrader,2023-02-07,2,2,1,3,55.69,0
Lich Clicker,2023-02-14,4,2,1,3,55.69,0
Death Trials (Director's Cut),2023-02-08,2,2,1,3,55.69,0
Lost Memories,2023-01-01,2,2,1,3,55.69,0
Astonishing Basketball Manager,2023-01-06,5,2,1,3,55.69,0
Souls of Tartarus,2023-03-17,2,2,1,3,55.69,0
Naturia,2023-01-30,3,2,1,3,55.69,0
Aunewyth,2023-01-20,1,2,1,3,55.69,0
Shadow Lens,2023-01-06,1,2,1,3,55.69,0
Akari: School Trip,2023-01-26,2,2,1,3,55.69,0
Idle Drift Kings,2023-01-31,5,2,1,3,55.69,0
Midnight Alert,2023-01-11,4,2,1,3,55.69,0
Dawn Of Hell,2023-02-20,3,2,1,3,55.69,0
Survive Now,2023-03-29,3,2,1,3,55.69,0
Demon Invasion: Endless,2023-01-14,4,2,1,3,55.69,0
A Terrible Place,2023-03-04,1,2,1,3,55.69,0
Dark Shrine,2023-01-18,3,2,1,3,55.69,0
Chess Defense Saga,2023-02-06,2,2,1,3,55.69,0
Milo no Senki 3,2023-03-06,3,2,1,3,55.69,0
HEROIC,2023-02-13,1,2,1,3,55.69,0
Crazy Designer,2023-03-02,5,2,1,3,55.69,1
Banana Clicker,2023-03-28,6,2,1,3,55.69,1
Sex Simulator - Pool Party,2023-02-23,4,2,1,3,55.69,1
VR Rescue Girls,2023-04-02,4,2,1,3,55.69,0
Hentai Galaxy,2023-03-13,2,2,1,3,55.69,0
Run On Home,2023-03-21,3,2,1,3,55.69,0
King War [RTS],2023-03-09,1,2,1,3,55.69,0
The PenguinGame -Antarctic Savior-,2023-03-23,2,2,1,3,55.69,0
Hinami Bay,2023-04-07,2,2,1,3,55.69,0
Lovers in Playa Rosa,2023-03-29,3,2,1,3,55.69,0
H Girl 2,2023-04-07,4,2,1,3,55.69,0
Zombie Rush,2023-03-29,2,2,1,3,55.69,0
MiLE HiGH TAXi,2023-03-13,40,41,30,71,55.61,0
Drift Stage,2023-01-13,12,25,18,43,55.53,0
Superfuse,2023-01-31,1914,438,345,783,55.14,11
Sex and Zombies,2023-02-02,6,6,4,10,55.14,0
Killfest,2023-01-31,4,6,4,10,55.14,0
Dead Profit,2023-01-03,15,10,7,17,55.13,0
Venture Valley,2023-01-24,447,24,18,42,54.84,0
Vendetta: Mafia Wars,2023-01-21,10,15,11,26,54.84,0
Monster Energy Supercross - The Official Videogame 6,2023-03-09,430,67,52,119,54.81,94
Brothel Simulator 🍓,2023-01-14,123,127,101,228,54.59,0
Auto Brawl Chess,2023-04-07,37,7,5,12,54.48,23
Keiko-san (47) my co-worker is a single mother,2023-02-15,10,7,5,12,54.48,0
Orcs Coming TD,2023-01-16,6,7,5,12,54.48,0
СИМУЛЯТОР ЛАЗАНЬЯ ПО ЗАБРОШКАМ,2023-02-10,15,31,24,55,54.47,1
Scott Pilgrim vs The World,2023-01-05,446,450,368,818,54.35,9
Madshot: Road to Madness,2023-02-23,25,12,9,21,54.33,1
Space Game: Star We There Yet?,2023-02-14,38,12,9,21,54.33,3
Farm Empire,2023-03-23,368,22,17,39,54.3,223
Wanted: Dead,2023-02-14,291,257,210,467,54.24,2
Watch Dogs: Legion,2023-01-26,5048,1378,1145,2523,54.18,341
Adventure Light,2023-02-01,4,3,2,5,54.17,0
LOST BETWEEN,2023-01-20,2,3,2,5,54.17,0
여동생 ♡ 만들기 : 당신이 바라는 소녀의 모습 - Teen version,2023-01-01,3,3,2,5,54.17,0
Magic Kingdom War,2023-01-20,4,3,2,5,54.17,0
Pop Journey,2023-02-27,3,3,2,5,54.17,0
Lockdown 2024,2023-01-21,21,3,2,5,54.17,2
Lincoln Green,2023-01-20,2,3,2,5,54.17,0
Horny Clinic,2023-01-09,3,3,2,5,54.17,0
SHATTER,2023-01-06,4,3,2,5,54.17,0
DUNGEON WALK－竜迷宮の管理者－,2023-01-04,18,3,2,5,54.17,0
【VR】Physical Exam / イタズラ身体測定,2023-01-19,3,3,2,5,54.17,0
Desktop Garage Kit,2023-03-03,2,3,2,5,54.17,0
Zombie Watch Part II,2023-03-23,7,3,2,5,54.17,0
Horny Hotel Maids,2023-03-20,2,3,2,5,54.17,0
Furry Sweeper,2023-02-21,4,3,2,5,54.17,0
Meet Ball Girls,2023-02-02,2,3,2,5,54.17,0
Pattaya,2023-02-03,2,3,2,5,54.17,0
Emotions: Social MeDie,2023-02-17,2,3,2,5,54.17,0
More than words,2023-03-09,2,3,2,5,54.17,0
Polyturned,2023-02-23,5,3,2,5,54.17,0
Astronomic Date,2023-02-17,3,3,2,5,54.17,0
Jigsaw Realm 3D,2023-02-10,2,3,2,5,54.17,0
Tribefort,2023-03-31,6,3,2,5,54.17,0
人妻学園　～営み指導で調教ッ！？ハメ堕ちする清純妻～,2023-03-15,1,3,2,5,54.17,0
SANRI,2023-01-09,11,13,10,23,54.02,0
sim4D ATC,2023-03-31,33,19,15,34,53.87,3
浮生箓2：九九行歌,2023-02-20,206,117,97,214,53.75,11
僵尸（THE JIANG SHI）,2023-01-01,5,14,11,25,53.75,0
Grimgrad,2023-04-05,74,20,16,36,53.68,4
Drift Experience Japan,2023-02-07,76,52,43,95,53.54,3
Floor44,2023-03-09,80,46,38,84,53.51,7
Zhiel's Mystery,2023-02-22,2,4,3,7,53.32,0
Iaijutsu,2023-12-31,2,4,3,7,53.32,0
FINAL AGE,2023-03-30,3,4,3,7,53.32,0
Satay Shop Tycoon,2023-02-08,2,4,3,7,53.32,0
Futa Heroism,2023-01-06,5,4,3,7,53.32,0
Just Futanari,2023-02-03,5,4,3,7,53.32,0
Invincible Medusa,2023-01-23,5,4,3,7,53.32,0
ReverseRoom,2023-02-22,5,4,3,7,53.32,0
Dot,2023-01-25,2,4,3,7,53.32,0
Forkscythe,2023-03-29,2,4,3,7,53.32,0
SUA,2023-01-28,4,4,3,7,53.32,0
Dark City: International Intrigue,2023-03-06,13,4,3,7,53.32,1
二次元老婆生成器,2023-01-09,92,30,25,55,53.19,17
Malody V,2023-02-28,30,103,89,192,52.9,13
Brinefall,2023-04-03,55,27,23,50,52.78,0
SEX Drugs and CYBERPUNK,2023-01-06,11,12,10,22,52.78,1
错误之事,2023-01-19,9,12,10,22,52.78,0
Sass VS Fash: Girlballs of Steel,2023-01-02,2,5,4,9,52.78,0
Abandoned drive-in | 廃ドライブイン,2023-01-29,27,5,4,9,52.78,0
她与绳,2023-02-24,3,5,4,9,52.78,0
Guns & Fishes,2023-02-01,11,35,30,65,52.76,1
有个小村：逍遥,2023-01-10,48,28,24,52,52.68,0
苟延残喘,2023-01-23,2,6,5,11,52.39,0
Alchemia Story,2023-02-22,123,45,40,85,52.17,46
Evil's Den: Forsaken Dungeon,2023-03-07,4,7,6,13,52.11,0
Curse of Kisera,2023-02-14,21,7,6,13,52.11,0
Grace Online,2023-03-03,8,8,7,15,51.89,0
Sapper - Defuse The Bomb Simulator,2023-01-23,63,37,34,71,51.53,0
14 Days of Desire,2023-02-03,16,11,10,21,51.44,0
Curse of the Sea Rats,2023-04-06,118,40,39,79,50.46,12
Kerbal Space Program 2,2023-02-24,25724,6828,6764,13592,50.22,816
Garten of Banban,2023-01-06,770,2237,2223,4460,50.14,297
Cursed,2023-01-04,23,28,28,56,50.0,0
Cursed,2023-01-04,23,28,28,56,50.0,0
Cursed,2023-01-04,23,28,28,56,50.0,1
Cursed,2022-02-18,10,69,9,78,78.14,0
Cursed,2022-02-18,10,69,9,78,78.14,0
Cursed,2022-02-18,10,69,9,78,78.14,1
Cursed,2016-06-17,211,507,124,631,75.99,0
Cursed,2016-06-17,211,507,124,631,75.99,0
Cursed,2016-06-17,211,507,124,631,75.99,1
Stay Still,2023-01-06,14,23,23,46,50.0,0
Samurai Slaughter House,2023-03-31,14,21,21,42,50.0,1
Claris the Princess Knight ~ Extra Story,2023-01-18,5,10,10,20,50.0,0
Film Studio Manager,2023-03-17,15,9,9,18,50.0,1
Plains of Pain,2023-02-17,7,8,8,16,50.0,0
ACL Pro Cornhole,2023-03-29,62,7,7,14,50.0,1
Nash Racing: 70 seconds left,2023-01-05,3,7,7,14,50.0,0
Cat Girl Creator,2023-02-14,3,6,6,12,50.0,1
Hentai Mikky,2023-03-08,2,6,6,12,50.0,0
Exorcism Ritual,2023-01-10,3,5,5,10,50.0,1
Synthwave FURY,2023-02-10,3,5,5,10,50.0,0
Wormhole Cafe,2023-03-02,5,5,5,10,50.0,0
A SIMPLE REQUEST,2023-03-01,2,4,4,8,50.0,0
Third,2023-02-02,3,4,4,8,50.0,0
Fight & Crush,2023-02-08,3,4,4,8,50.0,0
League Funny 遊戲大亂鬪,2023-03-31,34,4,4,8,50.0,0
Barrett Foster : Prologue,2023-03-27,3,4,4,8,50.0,0
The Most Lecherous,2023-03-29,6,4,4,8,50.0,0
BRoS - Battle Royale of Survival,2023-03-10,6,3,3,6,50.0,0
Zen Paint,2023-02-13,4,3,3,6,50.0,0
A Rum Tale,2023-01-05,1,3,3,6,50.0,0
Metal Punch,2023-03-05,2,3,3,6,50.0,0
人形の傷跡：姉の謎を追うサイコホラー,2023-03-25,7,3,3,6,50.0,0
Sleight of Hand: Dynasty,2023-02-15,2,3,3,6,50.0,0
Army War: Shooting Simulator,2023-02-06,2,3,3,6,50.0,0
Citadale Resurrection,2023-02-02,3,3,3,6,50.0,1
Taxi Driver Simulator: Car Parking,2023-02-09,5,3,3,6,50.0,0
Minigames Master,2023-03-03,2,3,3,6,50.0,0
Dead Inside,2023-03-01,1,3,3,6,50.0,0
Saving Mei,2023-03-06,4,3,3,6,50.0,7
工业战争,2023-03-28,4,3,3,6,50.0,1
Fantasy Empires,2023-03-27,20,3,3,6,50.0,3
Brain Damage,2023-04-03,3,3,3,6,50.0,1
Gogte,2023-02-09,2,2,2,4,50.0,0
One Tank Army,2023-01-20,3,2,2,4,50.0,0
Monsters of Seabrook,2023-02-17,5,2,2,4,50.0,1
Merchant of Bohemia,2023-02-15,2,2,2,4,50.0,0
ANGEL DROID,2023-02-16,3,2,2,4,50.0,0
Dark spell,2023-02-10,5,2,2,4,50.0,0
Conquering Married Women through Sex,2023-03-16,7,2,2,4,50.0,1
Dinosaur Simulator,2023-03-02,3,2,2,4,50.0,0
Courier Tycoon,2023-03-03,2,2,2,4,50.0,0
Package Dudes,2023-01-31,3,2,2,4,50.0,0
Cleaning Queens,2023-02-03,5,2,2,4,50.0,0
Christmas Land,2023-01-10,1,2,2,4,50.0,0
Blue Sky,2023-01-09,2,2,2,4,50.0,0
国产手机帝国-Mobile phone empire,2023-01-05,2,2,2,4,50.0,0
Old Shadow,2023-01-27,1,2,2,4,50.0,0
The Dark Side Of Mars,2023-01-24,4,2,2,4,50.0,0
Death Gunfire - Kill the Zombie,2023-02-20,3,2,2,4,50.0,0
EQUAL PEOPLE,2023-01-27,1,2,2,4,50.0,0
Hentai Secrets,2023-03-20,2,2,2,4,50.0,0
Hentai Secrets,2023-03-20,2,2,2,4,50.0,0
Hentai Secrets,2019-01-31,20,466,60,526,82.74,0
Hentai Secrets,2019-01-31,20,466,60,526,82.74,0
街机捕鱼城-经典万炮捕鱼,2023-03-27,12,2,2,4,50.0,5
Cargo Truck Simulator 2023,2023-02-19,3,2,2,4,50.0,0
HOW,2023-03-13,3,2,2,4,50.0,0
十月怪谈,2023-03-17,5,2,2,4,50.0,0
KITS,2023-04-30,5,2,2,4,50.0,0
Survival Sprint,2023-03-29,4,2,2,4,50.0,0
DeathKeep,2023-03-31,6,2,2,4,50.0,0
Kriaturaz,2023-03-18,1,1,1,2,50.0,0
Evil Below,2023-02-17,3,1,1,2,50.0,0
Super Sketchy Party,2023-03-27,1,1,1,2,50.0,0
Thief vs Detective Blonde Lady,2023-02-08,3,1,1,2,50.0,0
Emperial Knights,2023-03-15,2,1,1,2,50.0,0
Darwin's Aquarium,2023-01-10,4,1,1,2,50.0,0
Barnstormers: Determined to Win,2023-03-22,2,1,1,2,50.0,0
The Bastonnes,2023-03-15,4,1,1,2,50.0,0
ギルド受付嬢フィリス,2023-03-20,10,1,1,2,50.0,1
Captain!,2023-02-02,2,1,1,2,50.0,0
What's your emergency,2023-01-31,2,1,1,2,50.0,0
Evolution Tale,2023-03-02,6,1,1,2,50.0,0
Vanessa,2023-02-20,2,1,1,2,50.0,0
First Time in Hawaii,2023-02-15,4,1,1,2,50.0,0
Overdelivery,2023-03-28,1,1,1,2,50.0,0
Ringborn,2023-01-12,2,1,1,2,50.0,0
Phantom Island,2023-03-10,1,1,1,2,50.0,0
Brichi Quest,2023-01-05,2,1,1,2,50.0,0
Village and The Witch,2023-01-04,4,1,1,2,50.0,0
Universal Truck Simulator Tow Games,2023-02-21,2,1,1,2,50.0,0
Petit Petit Petit,2023-03-16,7,1,1,2,50.0,1
Not born to be King,2023-02-10,1,1,1,2,50.0,0
PigShip and the Giant Wolf,2023-02-24,1,1,1,2,50.0,0
Neon Noir,2023-01-05,2,1,1,2,50.0,0
Fair Princess Under Futa Curse,2023-03-07,5,1,1,2,50.0,0
剑仙的副本,2023-04-01,2,1,1,2,50.0,0
ChessBase 17 SE,2023-02-28,5,1,1,2,50.0,0
A Game You Can Afford In This Economy,2023-03-08,2,1,1,2,50.0,0
Chains of Time,2023-03-02,4,1,1,2,50.0,0
Heirs of the Kings,2023-02-03,8,1,1,2,50.0,1
Eastern Europe Train Sim,2023-01-25,2,1,1,2,50.0,0
WAR Card Game_uvr,2023-02-01,1,1,1,2,50.0,0
Secret Dimension,2023-02-06,1,1,1,2,50.0,0
Crossroad of Worlds: Mystery Agency Collector's Edition,2023-02-02,4,1,1,2,50.0,0
Void: Edge of Existence,2023-01-02,3,1,1,2,50.0,0
Digital Virus,2023-02-09,2,1,1,2,50.0,0
ハーデリアクエスト,2023-01-24,2,1,1,2,50.0,0
Hentai Jigsaw Puzzle Collection: Christmas Edition,2023-01-07,1,1,1,2,50.0,0
Red Flower,2023-01-09,2,1,1,2,50.0,0
Pong Ping,2023-02-16,2,1,1,2,50.0,0
Mecha Blade,2023-01-01,1,1,1,2,50.0,0
Our Memories - Hentai,2023-03-09,2,1,1,2,50.0,0
Star Hive: The Menace,2023-03-02,3,1,1,2,50.0,0
海伦的神迹,2023-02-24,1,1,1,2,50.0,0
Find the Whales Español,2023-01-12,1,1,1,2,50.0,0
Golden Gloves VR,2023-02-15,1,1,1,2,50.0,0
Earth Mars,2023-02-04,1,1,1,2,50.0,0
三国群英战略版,2023-01-25,2,1,1,2,50.0,1
Obsta-Loop,2023-03-31,3,1,1,2,50.0,0
Skyemont Battle,2023-02-28,1,1,1,2,50.0,0
Castle Destroyers,2023-02-25,2,1,1,2,50.0,0
栽培人计划：Meet a Date!,2023-01-31,1,1,1,2,50.0,0
Dark Desire Mute 2,2023-02-03,2,1,1,2,50.0,0
Vault City,2023-03-30,2,1,1,2,50.0,0
City Ambulance Car Driving,2023-02-07,2,1,1,2,50.0,0
The City: Superhero Flying Experience,2023-02-14,3,1,1,2,50.0,0
我的拿汀學姐,2023-03-31,2,1,1,2,50.0,0
Book of Shardows,2023-02-14,1,1,1,2,50.0,0
Stay in,2023-02-11,2,1,1,2,50.0,0
First Light,2023-04-07,3,1,1,2,50.0,0
Real Zombie War Simulator,2023-02-16,3,1,1,2,50.0,0
Modo Defence,2023-03-12,4,1,1,2,50.0,0
Gradient,2023-02-21,2,1,1,2,50.0,0
Slide Puzzle: Cute Moe Girls,2023-03-23,2,1,1,2,50.0,0
Coerced: Unexpected Detention,2023-03-31,4,1,1,2,50.0,0
Psychic Investigation of Sakuragi Haru,2023-03-22,7,1,1,2,50.0,0
Hentai Cookie,2023-03-20,1,1,1,2,50.0,0
AlcoFox,2023-04-10,1,1,1,2,50.0,0
Sex Simulator - Girl on Girl,2023-03-21,3,1,1,2,50.0,0
Keyboard Warrior,2023-03-31,2,1,1,2,50.0,0
Keyboard Warrior,2023-03-31,2,1,1,2,50.0,0
Keyboard Warrior,2023-03-31,2,1,1,2,50.0,0
Keyboard Warrior,2022-07-15,6,32,4,36,75.77,0
Keyboard Warrior,2022-07-15,6,32,4,36,75.77,0
Keyboard Warrior,2022-07-15,6,32,4,36,75.77,0
Keyboard Warrior,2018-02-23,1,1,1,2,50.0,0
Keyboard Warrior,2018-02-23,1,1,1,2,50.0,0
Keyboard Warrior,2018-02-23,1,1,1,2,50.0,0
The Dungeon Vendor,2023-04-06,3,1,1,2,50.0,0
Mizz Survival,2023-04-04,4,1,1,2,50.0,0
darkside,2023-04-07,4,1,1,2,50.0,0
GUNSHIP,2023-04-09,3,1,1,2,50.0,0
Moviehouse - The Film Studio Tycoon,2023-04-05,294,80,81,161,49.76,27
Idle Clans,2023-04-07,489,39,40,79,49.54,556
Conquest Emperor,2023-04-07,13,25,26,51,49.32,0
The Last of Us™ Part I,2023-03-28,36496,13254,13679,26933,49.25,"6,846"
Ravenbound,2023-03-30,1104,284,296,580,49.12,68
Warhammer Age of Sigmar: Soul Arena,2023-01-19,227,99,104,203,49.02,8
Hidden Islands,2023-03-22,7,11,12,23,48.66,0
Propaganda Inc.,2023-01-03,40,10,11,21,48.56,1
联盟大乱斗,2023-01-04,822,90,97,187,48.52,293
Bless Global,2023-03-01,466,121,131,252,48.39,237
ANETHA,2023-03-20,11,8,9,17,48.29,0
Not For Broadcast VR,2023-03-23,7,8,9,17,48.29,0
PumPum 2,2023-03-31,30,18,20,38,48.24,1
她的脚,2023-01-20,6,7,8,15,48.11,0
Novastella Island,2023-01-17,127,166,184,350,47.87,1
DEAD CIDE CLUB,2023-02-28,1951,411,454,865,47.84,35
Coal Mining Simulator,2023-04-11,399,13,15,28,47.72,51
Richman 6,2023-03-16,16,13,15,28,47.72,8
Wo Long: Fallen Dynasty,2023-03-03,75906,10082,11121,21203,47.67,"2,002"
House Builder VR,2023-03-06,3,5,6,11,47.61,0
bloody lonely cold,2023-01-28,4,12,14,26,47.58,0
Kink.Inc,2023-03-20,62,11,13,24,47.41,40
The Magic Land,2023-03-04,16,11,13,24,47.41,1
Flight Attendant Simulator VR,2023-02-23,9,4,5,9,47.22,0
Monster Knockout,2023-01-03,2,4,5,9,47.22,0
Cars vs Train,2023-01-09,2,4,5,9,47.22,0
Backrooms - Surreality,2023-01-29,4,4,5,9,47.22,0
Spelljammer: Pirates of Realmspace,2023-03-31,17,4,5,9,47.22,1
有个小村,2023-01-10,3,3,4,7,46.68,0
Lumien,2023-03-29,4,3,4,7,46.68,0
Criminal Expert,2023-01-13,10,3,4,7,46.68,1
Dragon Survivors,2023-02-22,5,3,4,7,46.68,0
Battle for borders,2023-02-22,5,7,9,16,46.41,0
Eleonor's Nightmares,2023-01-08,5,7,9,16,46.41,1
ONI : Road to be the Mightiest Oni,2023-03-08,31,21,26,47,46.34,2
Spirit Eyes,2023-03-01,1,2,3,5,45.83,0
Armored Battalion,2023-02-04,2,2,3,5,45.83,0
Maiden Kingdom,2023-03-31,5,2,3,5,45.83,0
Sears: The Sky Frontier,2023-03-06,1,2,3,5,45.83,0
Detective Super Star,2023-02-10,7,2,3,5,45.83,0
The Starving Tournament,2023-01-06,5,2,3,5,45.83,0
Find the Birds,2023-01-12,3,2,3,5,45.83,0
WILD HEARTS™,2023-02-16,28511,4415,5330,9745,45.6,"1,970"
Redemption's Guild,2023-02-24,13,5,7,12,45.52,0
Russian Train Trip 2,2023-03-07,5,11,15,26,45.16,6
Here To Stay,2023-03-11,11,4,6,10,44.86,0
Bus Simulator: Car Driving,2023-01-25,5,4,6,10,44.86,0
迷之战果,2023-03-06,34,4,6,10,44.86,3
Hidden Ghost Town,2023-03-21,2,6,9,15,44.34,0
Shoot! VR,2023-03-31,7,6,9,15,44.34,1
Please FUCK ME my neighbor,2023-02-10,8,6,9,15,44.34,0
The Unearthened,2023-02-05,3,1,2,3,44.31,0
Moving Forward,2023-01-15,2,1,2,3,44.31,0
Reddish,2023-01-19,2,1,2,3,44.31,0
Fortune the Fated,2023-01-19,10,1,2,3,44.31,0
The Outer Space Bugs,2023-02-26,2,1,2,3,44.31,0
Phoenix Nightmare,2023-02-08,2,1,2,3,44.31,0
Cyber Cartels,2023-04-01,4,1,2,3,44.31,0
Project: Nightlight,2023-03-10,2,1,2,3,44.31,0
My Land!,2023-01-04,3,1,2,3,44.31,1
CyberHeroes Arena DX,2023-03-31,2,1,2,3,44.31,0
Oli One: Sneak in,2023-03-09,1,1,2,3,44.31,0
Remember U,2023-01-31,2,1,2,3,44.31,0
X-Sports,2023-01-12,3,1,2,3,44.31,0
Road Trucker,2023-01-03,1,1,2,3,44.31,0
Ultra Fishing,2023-01-18,1,1,2,3,44.31,0
丧尸世界,2023-03-10,3,1,2,3,44.31,0
Truck Simulator Ultimate 3D,2023-01-30,3,1,2,3,44.31,0
Fingers' Dating,2023-02-09,3,1,2,3,44.31,0
GUNWATCH: Conflict Survival,2023-01-27,3,1,2,3,44.31,0
Extreme Car Drift Simulator,2023-02-03,4,1,2,3,44.31,0
Putridum,2023-02-23,1,1,2,3,44.31,0
Target G,2023-02-23,1,1,2,3,44.31,0
Dogs Day,2023-02-20,2,1,2,3,44.31,0
Space Pop - Bubble Shooter,2023-03-02,2,1,2,3,44.31,1
Project Horror Tales,2023-03-10,2,1,2,3,44.31,0
我穿越到了魔法世界,2023-03-31,1,1,2,3,44.31,0
Spider Queen cave,2023-02-05,87,60,81,141,44.23,1
Knights of Legends,2023-03-24,7,3,5,8,43.95,1
Art Girl 2,2023-01-06,8,3,5,8,43.95,0
X-Racing,2023-02-03,2,3,5,8,43.95,0
SpaceInvasion,2023-02-28,15,5,8,13,43.68,5
CHERNOBYL - Death May Die,2023-02-21,2,4,7,11,42.82,0
Dark Days : Devil Hunt Prologue,2023-01-12,21,4,7,11,42.82,0
EA SPORTS™ PGA TOUR™,2023-04-07,1796,154,220,374,42.66,870
Deliria,2023-02-22,6,2,4,6,42.61,0
PK Girls,2023-01-17,3,2,4,6,42.61,0
Super Spy Steve,2023-03-24,10,2,4,6,42.61,1
Draft Day Sports: College Basketball 2023,2023-03-10,42,2,4,6,42.61,12
Into the Backrooms,2023-03-31,3,2,4,6,42.61,0
Hidden Magic Town,2023-03-23,2,5,9,14,42.04,0
Manacle | 猪仔,2023-03-27,8,6,11,17,41.45,0
Project Speed 2,2023-01-03,20,12,21,33,41.08,0
Gambit!,2023-04-06,29,10,18,28,40.9,0
Uncharted Waters Origin,2023-03-06,4880,390,596,986,40.86,"3,427"
Lovely Girl Puzzle,2023-02-27,1,0,1,1,40.58,0
Frontline Grunt,2023-01-27,1,0,1,1,40.58,0
Hyparxis,2023-03-08,2,0,1,1,40.58,0
Charem of Metropolitan,2023-01-17,1,0,1,1,40.58,0
Wind Of Life,2023-01-23,1,0,1,1,40.58,0
Three Defilements,2023-02-22,1,0,1,1,40.58,0
Godtail: First Cut,2023-02-22,1,0,1,1,40.58,0
Chicago 2020,2023-03-02,2,0,1,1,40.58,0
Unblocking,2023-02-10,1,0,1,1,40.58,0
Eftu,2023-03-17,4,0,1,1,40.58,0
Risky Woods,2023-02-01,1,0,1,1,40.58,0
BrainAccelerator,2023-02-14,2,0,1,1,40.58,0
Dungeonrite,2023-01-17,2,0,1,1,40.58,0
GUTTERBRAWLERS,2023-03-28,1,0,1,1,40.58,0
What was,2023-01-14,1,0,1,1,40.58,0
Escape Jump,2023-01-09,2,0,1,1,40.58,0
Eternal Space,2023-03-16,1,0,1,1,40.58,0
Squad Game,2023-03-31,2,0,1,1,40.58,0
Sword King,2023-02-03,1,0,1,1,40.58,0
Futr8,2023-01-13,4,0,1,1,40.58,0
世界征服者-成吉思汗（World Conqueror - Genghis Khan）,2023-03-17,1,0,1,1,40.58,0
eXecutor,2023-03-24,1,0,1,1,40.58,0
Somerholm,2023-02-24,1,0,1,1,40.58,0
REX,2023-03-31,1,0,1,1,40.58,0
REX,2023-03-31,1,0,1,1,40.58,0
REX,2021-12-08,1,0,2,2,35.92,0
REX,2021-12-08,1,0,2,2,35.92,0
YOU ARE THE DINNER,2023-01-13,2,0,1,1,40.58,0
Look Find Find,2023-04-06,1,0,1,1,40.58,0
DoTeam,2023-01-12,1,0,1,1,40.58,0
声灵,2023-02-09,3,0,1,1,40.58,0
BLOCkCORsair,2023-03-17,1,0,1,1,40.58,0
Liars' Race in Lost Ruins,2023-01-24,3,0,1,1,40.58,0
Kung Fu School,2023-01-13,1,0,1,1,40.58,0
Aw Heck WAR!,2023-03-16,1,0,1,1,40.58,0
The Dungeon Rules,2023-01-18,1,0,1,1,40.58,0
Umbrella Escape,2023-01-17,1,0,1,1,40.58,0
Towers Turrets Turtles,2023-01-06,3,0,1,1,40.58,0
Orc Survivors,2023-01-11,1,0,1,1,40.58,0
Inky & Blinky,2023-02-16,1,0,1,1,40.58,0
winVGF,2023-01-05,2,0,1,1,40.58,0
Cool Cats,2023-01-15,1,0,1,1,40.58,0
Qiybz,2023-02-02,1,0,1,1,40.58,0
Hiden Ruin,2023-02-01,1,0,1,1,40.58,0
Towering,2023-01-06,1,0,1,1,40.58,0
Battle Mage,2023-01-03,1,0,1,1,40.58,0
Super Kids Racing : Mini Edition,2023-01-25,2,0,1,1,40.58,0
Office Mayhem,2023-01-01,2,0,1,1,40.58,0
Nature,2023-01-06,1,0,1,1,40.58,0
Stunts above Clouds,2023-01-31,2,0,1,1,40.58,0
2032: A New Threat,2023-01-05,2,0,1,1,40.58,0
Roxroria: An Island Of Treasures,2023-01-26,1,0,1,1,40.58,0
Valkyrie: Dawn of Ragnarok,2023-01-11,2,0,1,1,40.58,0
Bargain Blocz,2023-01-06,2,0,1,1,40.58,0
Kitten Kingdom,2023-01-17,1,0,1,1,40.58,0
Simp,2023-01-23,1,0,1,1,40.58,0
Space Escaper,2023-01-31,1,0,1,1,40.58,0
Lunar Mountain,2023-02-28,1,0,1,1,40.58,0
Blood Money Good Money,2023-02-28,2,0,1,1,40.58,0
Kong Hero,2023-01-18,2,0,1,1,40.58,0
Animal Kingdom,2023-02-15,2,0,1,1,40.58,0
建造师模拟器,2023-01-30,2,0,1,1,40.58,0
Have a Bloody Goal,2023-03-01,2,0,1,1,40.58,0
CallOfTree,2023-01-26,1,0,1,1,40.58,0
Put Your Brain On 2,2023-02-03,1,0,1,1,40.58,0
Saki - sakuseikan.,2023-02-02,2,0,1,1,40.58,0
Garden of God,2023-02-02,2,0,1,1,40.58,0
Bargain Invaders,2023-01-30,1,0,1,1,40.58,0
Learn Japanese,2023-01-27,2,0,1,1,40.58,0
Binarion,2023-03-31,1,0,1,1,40.58,0
Top Race,2023-02-08,1,0,1,1,40.58,0
One Drone,2023-02-09,1,0,1,1,40.58,0
The Duduk Master,2023-01-27,1,0,1,1,40.58,0
Sex Adventures - Love Yacht,2023-01-17,2,0,1,1,40.58,0
Dungeons and Myths 2,2023-01-31,2,0,1,1,40.58,0
Karakuru,2023-02-02,2,0,1,1,40.58,0
Line Honey,2023-02-16,2,0,1,1,40.58,0
Komodo 3K Arena,2023-02-04,1,0,1,1,40.58,0
METEOR COMMANDER,2023-01-26,1,0,1,1,40.58,0
SparkleWand Puzzle,2023-04-03,1,0,1,1,40.58,0
Toy Flying Car,2023-02-06,1,0,1,1,40.58,0
Size story,2023-02-28,1,0,1,1,40.58,0
Question Mark,2023-02-18,1,0,1,1,40.58,0
DESTROY Simulator VR,2023-02-14,2,0,1,1,40.58,0
The Little Witch Shop: New in Town,2023-03-11,2,0,1,1,40.58,0
Eternal Hunt,2023-03-19,1,0,1,1,40.58,0
Containment Search,2023-03-31,2,0,1,1,40.58,0
Qualification as Rogue,2023-04-06,2,0,1,1,40.58,0
Mafia in Town,2023-03-01,1,0,1,1,40.58,0
Money Maker,2023-04-05,3,0,1,1,40.58,0
Money Maker,2023-04-05,3,0,1,1,40.58,0
Money Maker,2018-11-23,136,17,2,19,73.45,0
Money Maker,2018-11-23,136,17,2,19,73.45,0
Sexy Dream Girl: Puzzle,2023-03-09,1,0,1,1,40.58,0
Toy Rider,2023-02-28,2,0,1,1,40.58,0
WWW,2023-03-21,1,0,1,1,40.58,0
Road To Place,2023-03-02,1,0,1,1,40.58,0
Within,2023-03-25,1,0,1,1,40.58,0
Threesome Puzzle,2023-03-14,2,0,1,1,40.58,0
Jurassic Pinball,2023-03-24,2,0,1,1,40.58,0
Monster Factory,2023-03-28,2,0,1,1,40.58,0
Necogram,2023-04-06,1,0,1,1,40.58,0
Medchess,2023-03-10,1,0,1,1,40.58,0
Island of the Dead,2023-03-10,1,0,1,1,40.58,0
穿梭世界,2023-03-23,2,0,1,1,40.58,0
Cum On Bus,2023-03-28,2,0,1,1,40.58,0
挠痒姐妹,2023-03-27,3,0,1,1,40.58,0
Beyond Polaris Guardian,2023-03-30,1,0,1,1,40.58,0
Beyond Polaris Guardian,2023-03-30,1,0,1,1,40.58,0
Beyond Polaris Guardian,2020-12-01,2,2,2,4,50.0,0
Beyond Polaris Guardian,2020-12-01,2,2,2,4,50.0,0
Book Travelers: A Victorian Story,2023-03-13,6,0,1,1,40.58,1
DobbyxEscape: Pirate Adventure,2023-03-31,1,0,1,1,40.58,0
Betrayal of Blood: a Strength & Virtue RPG,2023-03-31,1,0,1,1,40.58,0
Save District 3,2023-04-11,2,0,1,1,40.58,0
Waifu Puzzles,2023-04-04,2,0,1,1,40.58,0
Adult Puzzle - Hentai Aori,2023-04-08,2,0,1,1,40.58,0
Terminal Velocity,2023-04-04,1,0,1,1,40.58,0
Fluxion,2023-04-04,1,0,1,1,40.58,0
My Girl Hates Fruit,2023-04-07,2,0,1,1,40.58,0
HuaBing,2023-02-09,5,5,10,15,40.57,0
UnderBackroom,2023-02-03,112,25,43,68,40.46,0
Arithal,2023-03-27,2,1,3,4,40.4,0
Hammer 2 Reloaded,2023-03-05,3,1,3,4,40.4,0
After Wave: Downfall,2023-01-19,3,1,3,4,40.4,0
Home Office Simulator,2023-02-09,3,1,3,4,40.4,0
Rev Up! RC Grand Prix,2023-03-02,2,1,3,4,40.4,0
E-GIRL Next Door: Exposed,2023-01-08,5,1,3,4,40.4,0
Zombies in Metropolis,2023-01-16,1,1,3,4,40.4,0
Starless Hotel,2023-01-16,2,1,3,4,40.4,0
Aby's Playground,2023-02-18,2,1,3,4,40.4,0
Drift Experience Japan: Supporter Edition,2023-03-06,5,1,3,4,40.4,0
Metawork - Hotel Simulator,2023-04-08,8,1,3,4,40.4,5
Chests City Clicker,2023-03-09,18,9,17,26,40.32,1
Hentai Leaked!? Only for Fans,2023-01-27,13,10,19,29,40.06,0
BEAT AIMER!,2023-02-16,10,2,5,7,40.03,0
Zombie World Pixel,2023-01-15,2,2,5,7,40.03,0
Hidden Futa,2023-03-31,2,2,5,7,40.03,0
Battle of Guardians,2023-04-07,26,2,5,7,40.03,1
Onmyoji：the card game,2023-01-05,18,14,26,40,39.9,5
White Day2: The Flower That Tells Lies - EP1,2023-02-15,306,134,225,359,39.48,2
Volunteer,2023-01-02,2,4,9,13,39.46,0
Eternal Kingdom Battle Peak,2023-01-24,79,14,27,41,39.29,10
Sword and Fairy Inn,2023-03-30,86,18,34,52,39.27,19
Hidden Map,2023-03-20,2,5,11,16,39.24,1
Blood Bowl 3,2023-02-23,4045,926,1561,2487,38.45,291
Brewmastery,2023-12-31,6,2,6,8,37.9,1
万仙萌,2023-02-15,8,2,6,8,37.9,0
Polar Penguin,2023-03-07,3,1,4,5,37.49,0
In the Dark,2023-01-27,1,1,4,5,37.49,0
NIKKA : RISE,2023-01-06,5,1,4,5,37.49,0
MrWang And Love,2023-01-29,3,1,4,5,37.49,0
Horror Adventure,2023-02-18,2,1,4,5,37.49,0
巴克斯的庆典,2023-01-11,138,19,40,59,37.39,0
Outstand,2023-02-08,5,4,11,15,36.79,0
Only Sex in the Brothel,2023-01-31,10,3,9,12,36.55,0
The Outer Worlds: Spacer's Choice Edition,2023-03-07,347,161,313,474,36.47,98
Mask of Fury,2023-03-02,8,2,7,9,36.11,0
Pixel Slayer,2023-01-19,10,2,7,9,36.11,0
Outcasts of Dungeon,2023-01-19,1,0,2,2,35.92,0
Lunch Tycoon,2023-01-20,3,0,2,2,35.92,0
Gomorrah,2023-02-16,3,0,2,2,35.92,0
CrystalKeepers,2023-01-04,1,0,2,2,35.92,0
SAMURAI Survivor -Undefeated Blade-,2023-04-10,19,0,2,2,35.92,2
Backrooms: The Game,2023-01-14,2,0,2,2,35.92,0
The Alien Space Cat,2023-01-04,1,0,2,2,35.92,0
虹城,2023-01-05,1,0,2,2,35.92,0
Cut fruit,2023-01-05,1,0,2,2,35.92,0
University Life Visual Novel,2023-02-23,6,0,2,2,35.92,0
Bargain Toader,2023-01-12,2,0,2,2,35.92,0
TITS OKAY TITS FINE: LEWD ME DARLING,2023-02-10,2,0,2,2,35.92,0
Trained by a Succubus,2023-02-23,4,0,2,2,35.92,0
Futa Jigsaw Dating,2023-01-31,4,0,2,2,35.92,0
Sex Simulator - Hot Sauna,2023-01-21,3,0,2,2,35.92,0
Jet Fire,2023-02-06,1,0,2,2,35.92,0
百鬼幻想記,2023-02-23,1,0,2,2,35.92,0
E30 Drift Car Simulator,2023-02-10,3,0,2,2,35.92,0
The Azmodeus Project,2023-03-07,2,0,2,2,35.92,0
Tank Online: War Shooting Simulator,2023-03-07,3,0,2,2,35.92,0
Story of the Olivia,2023-03-23,1,0,2,2,35.92,0
Badlands,2023-01-19,11,4,12,16,35.65,0
Tomb 盜墓,2023-01-28,7,4,12,16,35.65,0
K-Pop & Rock Band Manager,2023-03-10,3,1,5,6,35.22,0
Idlenetics,2023-02-09,7,1,5,6,35.22,0
江湖十一,2023-01-11,10225,1750,3426,5176,35.04,12
The Dark Pictures Anthology: The Devil in Me - Friend's Pass,2023-02-15,59,10,27,37,34.71,5
Netherverse,2023-03-09,7,2,8,10,34.58,0
Last Stop,2023-03-13,5,2,8,10,34.58,0
Last Stop,2023-03-13,5,2,8,10,34.58,1
Last Stop,2021-07-22,35,142,45,187,70.57,0
Last Stop,2021-07-22,35,142,45,187,70.57,1
I Heard There Are Monsters Here,2023-03-07,55,12,33,45,34.04,14
Balloon Man,2023-02-08,3,1,6,7,33.38,0
Stepmom,2023-01-09,3,0,3,3,32.94,0
Wild West Dynasty,2023-02-16,2576,380,882,1262,32.43,11
ASU,2023-01-26,37,10,32,42,32.25,9
赌神模拟器：亚洲风云,2023-03-28,304,41,111,152,32.04,10
FlyWings 2018 Flight Simulator,2023-03-14,7,9,31,40,31.49,0
New Witch in Town,2023-01-26,39,2,11,13,31.03,0
Shadow's Kiss Online Vampire RPG,2023-01-06,10,2,11,13,31.03,1
Charades Movie One,2023-03-24,1,0,4,4,30.8,0
The Backrooms - Nightmare Dimension,2023-03-31,5,0,4,4,30.8,0
Chinese Expeditionary Force - Assault Team,2023-03-28,3,0,4,4,30.8,0
8 Ball 3,2023-01-27,9,0,4,4,30.8,0
Brain Hole Girls,2023-03-23,2,0,4,4,30.8,0
Merge Me!,2023-02-10,11,1,8,9,30.56,0
Lost In The Backrooms,2023-01-06,3,1,11,12,27.58,0
Variant 22,2023-02-03,7,1,11,12,27.58,0
Sex Prison,2023-03-13,7,1,11,12,27.58,0
Knights of Pen and Paper 3,2023-03-07,306,23,90,113,27.48,6
Slave,2023-01-20,4,1,12,13,26.81,0
SpaceDog,2023-01-24,3,1,12,13,26.81,0
Hack and Shoot Heroes,2023-01-09,5,0,7,7,26.74,1
Vampire Survivors,2022-10-20,77061,188186,2341,190527,97.52,"26,592"
Stray,2022-07-19,62963,113022,3016,116038,95.98,805
Entropy : Zero 2,2022-08-20,3751,15153,253,15406,95.7,185
PowerWash Simulator,2022-07-14,10512,33580,823,34403,95.56,"2,342"
God of War,2022-01-14,73529,96113,2959,99072,95.54,"4,258"
Neon White,2022-06-16,3277,10714,187,10901,95.34,133
Persona 5 Royal,2022-10-21,35474,33064,946,34010,95.18,"7,080"
Placid Plastic Duck Simulator,2022-07-06,647,7394,120,7514,95.11,168
Brotato,2022-09-27,30409,30573,914,31487,95.01,"14,481"
CULTIC,2022-10-13,738,3819,35,3854,95.0,20
Marvel’s Spider-Man Remastered,2022-08-12,66436,58877,2078,60955,94.9,"2,578"
The Looker,2022-06-17,1632,10957,259,11216,94.81,29
Dorfromantik,2022-04-28,7101,21530,639,22169,94.8,"1,014"
Wobbledogs,2022-03-15,591,6369,119,6488,94.74,132
Trombone Champ,2022-09-16,1067,6163,114,6277,94.72,93
The Case of the Golden Idol,2022-10-13,334,3222,32,3254,94.72,42
DAVE THE DIVER,2022-10-27,5239,10485,257,10742,94.7,673
Teardown,2022-04-21,8339,65324,2501,67825,94.69,"3,166"
Patrick's Parabox,2022-03-29,592,2270,14,2284,94.57,52
Lil Gator Game,2022-12-14,458,2078,11,2089,94.52,21
Ib,2022-04-11,2745,2432,21,2453,94.46,23
Stacklands,2022-04-08,5186,18021,599,18620,94.36,749
Metal: Hellsinger,2022-09-15,3569,8906,248,9154,94.26,85
A Building Full of Cats,2022-07-07,115,2274,24,2298,94.19,9
Half-Life 2: VR Mod,2022-09-16,1793,4086,83,4169,94.1,113
The Planet Crafter,2022-03-24,14253,19114,708,19822,94.07,"1,714"
乡村狂想曲,2022-10-05,2564,9452,293,9745,94.03,504
A Castle Full of Cats,2022-11-09,190,1638,11,1649,94.03,34
Monster Prom 3: Monster Roadtrip,2022-10-21,1774,2041,22,2063,94.02,43
ASTLIBRA ～生きた証～ Revision,2022-10-13,7000,13565,474,14039,93.99,"1,986"
Dungeon Munchies,2022-07-27,861,5727,156,5883,93.88,27
SuchArt!,2022-10-13,920,3336,69,3405,93.83,31
Lost in Play,2022-08-10,353,2465,40,2505,93.81,37
Monument Valley,2022-07-12,323,1880,22,1902,93.81,21
Outcore,2022-09-26,453,4552,120,4672,93.7,62
Bugsnax,2022-04-28,949,3199,69,3268,93.7,58
Sucker for Love,2022-01-20,247,2034,30,2064,93.67,7
Outpath: First Journey,2022-12-17,896,2826,59,2885,93.6,58
Frog Detective 3: Corruption at Cowboy County,2022-10-27,220,1071,4,1075,93.56,3
SIGNALIS,2022-10-27,872,6680,220,6900,93.54,94
月に寄りそう乙女の作法,2022-06-17,689,1892,29,1921,93.51,33
FreshWomen - Season 1,2022-08-19,3383,10476,400,10876,93.5,399
Cafe Stella,2022-03-25,1415,2211,40,2251,93.5,108
Aokana - EXTRA2,2022-12-16,531,919,1,920,93.5,19
Downfall - A Slay the Spire Fan Expansion,2022-03-25,3132,2453,51,2504,93.42,600
At Home Alone Final,2022-01-01,389,4260,124,4384,93.39,32
PlateUp!,2022-08-04,12460,11601,473,12074,93.36,"2,832"
提西探险社,2022-12-02,175,1789,29,1818,93.35,4
Retrowave,2022-05-07,638,12483,527,13010,93.3,80
怠惰的怪獸公主不想工作,2022-06-22,1102,3909,114,4023,93.29,60
Tiny Rogues,2022-09-23,1694,2835,70,2905,93.28,278
Will You Snail?,2022-03-09,705,2182,45,2227,93.27,8
枝江畔之梦,2022-01-27,541,1443,19,1462,93.27,0
NEEDY GIRL OVERDOSE,2022-01-21,3674,20831,988,21819,93.22,210
Chop Goblins,2022-12-12,198,1322,17,1339,93.15,5
Dialtown: Phone Dating Sim,2022-02-14,133,979,8,987,93.02,15
Slime Rancher 2,2022-09-22,21524,18421,902,19323,93.01,653
Dwarf Fortress,2022-12-06,28340,18874,929,19803,93.0,"1,965"
Tinykin,2022-08-30,262,1124,13,1137,92.98,29
POSTAL Brain Damaged,2022-06-09,764,4654,166,4820,92.93,55
Beacon Pines,2022-09-22,198,1282,20,1302,92.87,8
Aperture Desk Job,2022-03-01,3519,18042,924,18966,92.8,39
私のリアルは充実しすぎている フルボイス版,2022-12-16,1340,2286,63,2349,92.74,61
Raft,2022-06-20,101096,246467,16558,263025,92.68,"12,507"
Dinkum,2022-07-14,13412,14721,758,15479,92.63,"3,059"
COMPOUND,2022-07-19,102,1732,42,1774,92.62,6
Save Room - Organization Puzzle,2022-04-28,147,1617,38,1655,92.58,4
Farmer Against Potatoes Idle,2022-08-25,8951,3048,105,3153,92.54,"2,726"
Nightmare of Decay,2022-05-03,241,2448,76,2524,92.54,6
Against the Storm,2022-11-01,8425,8665,413,9078,92.53,"7,277"
I Was a Teenage Exocolonist,2022-08-25,688,1578,38,1616,92.49,70
Soulstone Survivors: Prologue,2022-08-26,4818,3855,150,4005,92.45,56
REFLEXIA Prototype ver.,2022-08-31,580,1823,50,1873,92.43,22
Cosmoteer: Starship Architect & Commander,2022-10-24,13794,6143,277,6420,92.42,937
Supraland Six Inches Under,2022-01-14,1973,2215,69,2284,92.4,53
Nova Lands: Emilia's Mission,2022-10-17,689,1443,34,1477,92.4,24
Symphony of War: The Nephilim Saga,2022-06-10,4383,6906,325,7231,92.37,580
Judgment,2022-09-14,5606,4129,169,4298,92.36,486
Strange Horticulture,2022-01-21,1356,6322,294,6616,92.33,89
BABBDI,2022-12-22,117,1387,33,1420,92.31,6
POPGOES Arcade,2022-07-01,258,1062,20,1082,92.28,7
Cult of the Lamb,2022-08-11,61780,44731,2859,47590,92.27,"1,415"
The Upturned,2022-03-23,38,611,4,615,92.21,4
SANABI,2022-06-20,415,2419,85,2504,92.19,26
Animal Revolt Battle Simulator,2022-04-15,1091,3915,166,4081,92.17,299
BROK the InvestiGator,2022-08-26,223,717,8,725,92.17,13
daydream 白日夢,2022-03-02,41,678,7,685,92.12,3
10 Minutes Till Dawn,2022-05-11,3444,4126,181,4307,92.11,0
Shadows Over Loathing,2022-11-11,3077,2021,67,2088,92.11,104
Bendy and the Dark Revival,2022-11-15,5703,7013,356,7369,92.07,93
Spark the Electric Jester 3,2022-08-14,239,1104,25,1129,92.03,11
Pentiment,2022-11-15,1250,2769,109,2878,92.01,127
The Past Within,2022-11-02,11642,9192,501,9693,92.0,185
Disney Dreamlight Valley,2022-09-06,14314,10603,595,11198,91.99,"4,649"
FAITH,2022-10-21,693,2717,107,2824,91.99,63
Spaceflight Simulator,2022-02-18,469,2681,105,2786,91.99,178
时间切片：序章,2022-11-24,196,1377,38,1415,91.99,7
The Stanley Parable: Ultra Deluxe,2022-04-27,13802,18935,1165,20100,91.96,180
Lily's Well,2022-01-04,140,1368,38,1406,91.96,9
Super Lesbian Animal RPG,2022-12-20,119,558,4,562,91.96,7
Love Delivery,2022-05-30,546,2029,72,2101,91.92,9
Resonance of the Ocean,2022-07-08,29,810,14,824,91.9,6
Insomnia: Theater in the Head,2022-12-16,80,1030,24,1054,91.85,1
Sudocats,2022-03-14,37,573,6,579,91.75,10
Warsim: The Realm of Aslona,2022-12-20,263,1120,30,1150,91.71,21
Klonoa Phantasy Reverie Series,2022-07-07,753,1198,34,1232,91.7,9
Not For Broadcast,2022-01-25,864,8726,504,9230,91.69,75
Ever Seen A Cat?,2022-01-18,15,504,4,508,91.67,1
Zodiacats,2022-01-21,37,446,2,448,91.67,3
Leap of Faith,2022-02-11,505,1240,37,1277,91.63,37
Teenage Mutant Ninja Turtles: Shredder's Revenge,2022-06-16,11933,10391,631,11022,91.59,92
A Taste of the Past,2022-03-11,47,848,19,867,91.57,21
恋爱绮谭 不存在的真相,2022-10-28,437,1356,45,1401,91.51,15
Capybara Spa,2022-03-14,188,1020,28,1048,91.5,2
所向之未来 - Towards Future,2022-02-18,28,474,4,478,91.49,1
Marvel's Spider-Man: Miles Morales,2022-11-18,13539,14033,909,14942,91.48,"1,005"
Dungeon Alchemist,2022-03-31,1181,1514,54,1568,91.47,300
Lost Judgment,2022-09-14,2269,2720,125,2845,91.45,533
Roadwarden,2022-09-12,622,1717,66,1783,91.44,60
Card Survival: Tropical Island,2022-09-16,2144,1256,41,1297,91.43,665
Sonic Frontiers,2022-11-08,19181,15493,1031,16524,91.41,377
Magical Girl Celesphonia,2022-05-07,1583,1503,55,1558,91.39,116
The Complex: Found Footage,2022-08-18,235,5019,279,5298,91.35,30
Tribal Hunter,2022-08-22,270,1039,31,1070,91.34,18
Last Command,2022-10-25,422,1283,44,1327,91.33,24
Lunistice,2022-11-10,104,825,21,846,91.27,5
Ember Knights,2022-04-20,1039,1975,86,2061,91.22,143
Turbo Overkill,2022-04-22,314,1690,70,1760,91.17,19
Treasure of Nadia,2022-02-16,1699,4295,241,4536,91.14,412
Acquitted,2022-05-02,137,758,19,777,91.14,0
Cave Crawler,2022-01-23,107,2480,120,2600,91.13,2
Prodeus,2022-09-23,716,4828,280,5108,91.11,44
ELDEN RING,2022-02-24,953426,609072,54122,663194,91.1,"49,704"
My Sticker Book,2022-08-24,27,767,20,787,91.09,0
Cut,2022-01-15,19,972,31,1003,91.05,3
The Legend of Heroes: Trails from Zero,2022-09-27,817,616,13,629,91.05,186
Baldi's Basics Classic Remastered,2022-10-21,847,4128,235,4363,91.03,77
DEATH STRANDING DIRECTOR'S CUT,2022-03-30,6093,14835,1052,15887,91.02,"2,989"
14 Minesweeper Variants,2022-11-14,346,427,5,432,90.99,160
Wylde Flowers,2022-09-20,653,747,20,767,90.98,152
Seal World,2022-04-01,14,344,2,346,90.93,1
Super Kiwi 64,2022-12-02,94,745,21,766,90.86,0
Melatonin,2022-12-15,314,2018,98,2116,90.84,154
瘟疫清零计划 Project Zero,2022-09-11,1172,2326,119,2445,90.82,89
Hook 2,2022-06-29,59,429,6,435,90.82,1
Freedom Planet 2,2022-09-13,964,1128,43,1171,90.81,11
Her New Memory,2022-02-08,261,3186,179,3365,90.8,10
How Fish Is Made,2022-01-14,96,2078,103,2181,90.8,3
Flatworld,2022-04-28,442,735,21,756,90.8,0
click to ten,2022-03-09,49,2161,109,2270,90.78,23
Lunacid,2022-03-15,547,1321,55,1376,90.78,225
One-armed cook,2022-08-30,2408,9986,704,10690,90.76,"1,143"
Gun Devil,2022-08-02,106,857,28,885,90.76,2
奇怪的RPG,2022-10-01,1160,2907,163,3070,90.71,182
暖雪 Warm Snow,2022-01-19,44702,24307,1916,26223,90.7,993
TYRONE vs COPS,2022-02-12,70,1626,76,1702,90.69,3
《文字遊戲》,2022-01-21,4105,4705,297,5002,90.67,16
Garden Galaxy,2022-12-14,415,536,12,548,90.65,99
Linelith,2022-05-19,65,385,5,390,90.64,1
Shredders,2022-03-16,697,1544,72,1616,90.62,83
Railbound,2022-09-06,365,775,25,800,90.61,16
Kiwi Clicker,2022-07-29,1320,773,25,798,90.6,112
梦魇：无归 Nightmare without return,2022-09-30,300,544,13,557,90.56,10
Shadow Burglar,2022-03-01,36,581,15,596,90.55,1
Fear & Hunger 2: Termina,2022-12-09,411,1035,41,1076,90.54,118
20 Minutes Till Dawn,2022-06-08,12953,18327,1443,19770,90.53,491
Citizen Sleeper,2022-05-05,570,3066,181,3247,90.53,66
The Lost Dachshund,2022-05-17,28,480,10,490,90.53,0
Her World,2022-10-06,137,349,4,353,90.52,4
Error143,2022-07-26,494,1574,76,1650,90.51,29
Yoiyami Dancers: Twilight Danmaku Dancers,2022-09-28,77,320,3,323,90.46,5
Five nights at Floppa,2022-02-18,40,910,35,945,90.41,0
Urbek City Builder: Prologue,2022-03-10,475,1405,67,1472,90.39,24
JellyCar Worlds,2022-12-08,97,333,4,337,90.36,13
Weed Shop 3,2022-04-21,2551,2828,170,2998,90.35,131
HYPER DEMON,2022-09-19,365,1541,77,1618,90.35,14
Deadeye Deepfake Simulacrum,2022-10-13,45,286,2,288,90.35,2
Little Noah: Scion of Paradise,2022-06-28,1478,1226,56,1282,90.34,21
Rock Life: The Rock Simulator,2022-07-21,515,1506,75,1581,90.33,12
Endling - Extinction is Forever,2022-07-19,232,810,30,840,90.31,11
I Frog-ot,2022-12-16,25,325,4,329,90.27,1
CaseCracker,2022-12-19,638,1685,89,1774,90.25,37
けものフレンズ Cellien May Cry,2022-05-01,302,664,22,686,90.24,3
TUNIC,2022-03-16,2501,7786,580,8366,90.23,235
Iron Lung,2022-03-10,172,5091,356,5447,90.2,12
Atelier Sophie 2: The Alchemist of the Mysterious Dream,2022-02-25,3622,1608,85,1693,90.18,98
打工吧！天使酱 ~天使在魔界的劳改生活~,2022-07-22,40,293,3,296,90.16,3
Rogue: Genesia ,2022-09-19,5178,4007,271,4278,90.14,461
Nightmare Reaper,2022-03-28,1159,2740,171,2911,90.13,58
Pulling No Punches,2022-08-10,122,415,9,424,90.13,2
Gloomwood,2022-09-05,1939,3109,200,3309,90.12,12
The Spirit and the Mouse,2022-09-26,57,310,4,314,90.1,0
her tears were my light,2022-09-28,5,216,0,216,90.1,0
Seraph's Last Stand,2022-03-23,771,2760,174,2934,90.09,43
Potion Craft: Alchemist Simulator,2022-12-13,10161,18485,1561,20046,90.07,"1,442"
Countryball: Europe 1890,2022-03-21,56,261,2,263,90.05,12
Kalinur,2022-08-18,44,405,9,414,90.04,0
Ex-Zodiac,2022-07-21,90,439,11,450,90.0,0
LEGO® Star Wars™: The Skywalker Saga,2022-04-05,82517,33926,3049,36975,89.99,"1,635"
Jaded,2022-04-29,73,506,15,521,89.96,0
常轨脱离Creative,2022-09-30,184,453,12,465,89.96,26
The Last Clockwinder,2022-06-02,64,359,7,366,89.96,1
The Zachtronics Solitaire Collection,2022-09-06,128,339,6,345,89.96,40
IronWolf VR,2022-04-12,45,979,45,1024,89.95,4
Ravenous Devils,2022-04-29,2415,5347,395,5742,89.94,59
Quaver,2022-08-19,891,10919,891,11810,89.93,216
GNOSIA,2022-01-23,1140,1821,107,1928,89.89,111
Return to Monkey Island,2022-09-19,15539,6639,513,7152,89.87,205
东方秘剑录,2022-02-14,55,575,20,595,89.83,1
Hush Hush - Only Your Love Can Save Them,2022-08-22,512,731,30,761,89.81,16
DRAINUS,2022-05-22,194,605,22,627,89.81,3
Moss: Book II,2022-10-20,64,243,2,245,89.81,10
Ever Seen A Cat? 2,2022-05-30,20,285,4,289,89.79,0
Shotgun King: The Final Checkmate,2022-05-12,769,3437,241,3678,89.78,85
Kena: Bridge of Spirits,2022-09-27,2643,7411,593,8004,89.74,297
Hana no No ni Saku Utakata no,2022-04-22,238,395,10,405,89.74,7
Last Call BBS,2022-08-03,770,734,31,765,89.72,39
Kinkoi Golden Time,2022-07-15,328,357,8,365,89.72,13
Shinobi Warfare,2022-06-14,209,1173,62,1235,89.7,112
Hatsune Miku: Project DIVA Mega Mix+,2022-05-26,2730,9189,766,9955,89.66,366
Instruments of Destruction,2022-03-02,335,724,31,755,89.65,49
Lucy Dreaming,2022-10-18,49,210,1,211,89.65,2
Core Keeper,2022-03-08,34508,21328,1942,23270,89.64,"5,270"
SuperTux,2022-01-12,82,646,26,672,89.63,17
Escape Dungeon 2,2022-01-14,868,1182,64,1246,89.62,32
Priest Simulator,2022-10-06,238,503,17,520,89.62,10
DOUKYUUSEI,2022-04-15,1325,1164,63,1227,89.59,47
Havsala: Into the Soul Palace,2022-06-21,170,466,15,481,89.58,0
The Testing Chamber,2022-03-28,23,465,15,480,89.57,1
Captain of Industry,2022-05-31,6135,2890,204,3094,89.55,"1,115"
Monument Valley 2,2022-07-12,105,783,36,819,89.55,11
ナツノカナタ,2022-08-17,296,636,26,662,89.55,11
Freshly Frosted,2022-06-10,43,224,2,226,89.52,0
Shattered Pixel Dungeon,2022-03-23,336,784,37,821,89.46,36
Owinka Shooter,2022-07-23,44,593,24,617,89.45,0
Vault of the Void,2022-10-04,1003,1984,131,2115,89.44,107
旅行こいし: デスクトップ少女 ~ Koishi Navigation Desktop Youkai,2022-08-02,482,544,21,565,89.42,53
Touch Some Grass,2022-04-11,23,495,18,513,89.39,16
Robin Morningwood Adventure,2022-09-30,140,410,13,423,89.33,30
Breadsticks,2022-11-05,34,360,10,370,89.33,2
怕不怕趴喵霸霸 Ghost Party Nyanbaba,2022-01-22,14,232,3,235,89.32,1
Tree Simulator 2023,2022-04-01,160,576,24,600,89.3,18
Choo-Choo Charles,2022-12-09,4058,9966,885,10851,89.29,124
Bio Prototype,2022-12-17,1984,922,49,971,89.29,"2,134"
A=B,2022-03-29,280,485,18,503,89.29,1
A Plague Tale: Requiem,2022-10-17,4927,8151,710,8861,89.27,377
Serious Sam: Siberian Mayhem,2022-01-25,1765,3032,227,3259,89.27,48
Soda Crisis,2022-05-24,1631,2340,166,2506,89.26,13
Growing My Grandpa!,2022-07-12,25,227,3,230,89.23,0
Depersonalization,2022-12-20,3044,2639,195,2834,89.18,89
FAR: Changing Tides,2022-03-01,989,2346,170,2516,89.15,141
Choice of Life: Middle Ages 2,2022-09-30,261,410,14,424,89.15,11
Charlie in the MoistVerse of Madness,2022-03-11,63,327,9,336,89.11,0
McPixel 3,2022-11-14,99,358,11,369,89.09,4
Tag: The Power of Paint,2022-04-18,77,509,21,530,89.08,9
Paradise Marsh,2022-10-13,43,218,3,221,89.08,0
fox soldier,2022-04-15,43,198,2,200,89.07,0
FIND ALL 2: Middle Ages,2022-03-03,24,177,1,178,89.07,0
The Death | Thần Trùng,2022-09-15,2894,2559,192,2751,89.06,6
The Night of the Scissors,2022-05-13,11,254,5,259,89.06,0
Ten Trials of Babel: The Doppelganger Maze,2022-03-14,642,2770,212,2982,89.03,15
Who's Lila?,2022-02-24,87,905,51,956,89.01,5
I'm on Observation Duty 5,2022-05-13,244,413,15,428,89.0,51
Evil Nun: The Broken Mask,2022-10-31,132,543,24,567,88.98,9
Ukraine Defense Force Tactics,2022-06-29,40,192,2,194,88.96,0
Tinyfolks,2022-06-01,436,780,42,822,88.94,5
Breeze,2022-08-05,35,331,10,341,88.94,1
HAYAI,2022-05-19,34,191,2,193,88.94,1
Smithworks,2022-06-17,604,1448,97,1545,88.93,33
Beeny,2022-10-15,11,228,4,232,88.92,0
Little Witch in the Woods,2022-05-17,4358,5472,479,5951,88.89,47
PAC-MAN WORLD Re-PAC,2022-08-25,313,587,28,615,88.87,6
Ever Seen A Cat? 3,2022-10-11,23,144,0,144,88.82,3
Aonatsu Line,2022-12-02,415,594,29,623,88.81,11
Yotsume God -Reunion-,2022-02-16,82,222,4,226,88.81,0
Endoparasitic,2022-10-24,430,1555,109,1664,88.79,7
Stay Out of the House,2022-10-14,191,669,35,704,88.78,11
Rollerdrome,2022-08-16,542,1124,72,1196,88.77,50
We Were Here Forever,2022-05-10,8390,8355,789,9144,88.72,365
The one who pulls out the sword will be crowned king,2022-03-28,2247,6916,639,7555,88.72,8
Prince of Suburbia - Part 1,2022-05-12,429,1091,70,1161,88.72,87
Pupperazzi,2022-01-20,100,346,12,358,88.71,1
Wicked Games,2022-07-27,13,180,2,182,88.71,0
Tile Cities,2022-05-05,167,404,16,420,88.7,6
Sunset Routes,2022-11-17,155,266,7,273,88.68,31
イハナシの魔女,2022-08-19,22,197,3,200,88.67,4
Islets,2022-08-24,127,429,18,447,88.66,6
角斗士学院,2022-03-01,42,342,12,354,88.65,0
花落冬陽 Snowdreams -lost in winter-,2022-03-09,95,228,5,233,88.59,0
The Divine Speaker,2022-03-30,133,192,3,195,88.57,1
Banana Shooter,2022-05-01,1768,7175,680,7855,88.56,602
Betrayal At Club Low,2022-09-09,52,275,8,283,88.56,4
Coral Island,2022-10-11,7487,5408,496,5904,88.55,"1,132"
Athanasy,2022-04-13,29,290,9,299,88.55,1
VOCÊ É UM DEFUNTO MECÂNICO,2022-01-10,10,319,11,330,88.53,0
A Story Beside,2022-05-24,20,206,4,210,88.49,0
Ninja Village,2022-05-23,254,206,4,210,88.49,16
Mega Serval,2022-11-30,20,170,2,172,88.49,0
Gerda: A Flame in Winter,2022-09-01,44,169,2,171,88.46,3
The Excavation of Hob's Barrow,2022-09-28,233,963,63,1026,88.42,9
群侠传，启动！,2022-09-16,548,568,30,598,88.42,39
What Lies in the Multiverse,2022-03-04,48,383,16,399,88.42,1
Void Sols,2022-11-17,32,219,5,224,88.41,3
Rogue Legacy 2,2022-04-28,22811,11375,1156,12531,88.39,529
The Sushi Spinnery,2022-05-23,227,234,6,240,88.39,14
Before The Night,2022-07-14,51,310,11,321,88.38,2
100 hidden fish,2022-01-17,24,265,8,273,88.38,0
Chasing Sunsets,2022-02-15,203,447,21,468,88.37,27
奇迹一刻 Surmount,2022-02-14,557,1250,90,1340,88.33,6
Your Blight,2022-11-10,70,181,3,184,88.32,7
Chained Echoes,2022-12-08,2212,2966,258,3224,88.31,458
Potato Flowers in Full Bloom,2022-03-10,272,305,11,316,88.3,7
Across the Obelisk,2022-08-16,14037,6898,675,7573,88.29,"3,929"
Soulstone Survivors,2022-11-07,18854,9391,954,10345,88.26,"1,771"
Just Go,2022-08-09,697,1557,120,1677,88.26,94
Infernax,2022-02-14,645,1238,90,1328,88.26,100
Donut Dodo,2022-06-03,19,142,1,143,88.26,2
Gunner HEAT PC!,2022-09-06,981,2075,171,2246,88.23,116
Magic Rampage,2022-05-24,314,741,46,787,88.23,46
Hidden Cats in London,2022-12-16,16,141,1,142,88.23,3
Please Be Happy,2022-11-21,72,159,2,161,88.22,3
Dark Egg,2022-08-28,38,193,4,197,88.21,0
The Mortuary Assistant,2022-08-02,1399,3760,346,4106,88.18,97
Alina of the Arena,2022-10-13,1636,2636,230,2866,88.15,75
The Entropy Centre,2022-11-03,615,1481,115,1596,88.15,64
Taiji,2022-09-09,733,651,39,690,88.15,9
Bone's Cafe,2022-10-29,64,173,3,176,88.13,11
Potato Survival,2022-10-11,23,137,1,138,88.12,2
NORCO,2022-03-24,120,1364,105,1469,88.08,15
Stardom 3 Deluxe,2022-03-31,2191,991,70,1061,88.07,135
Football Coach: College Dynasty,2022-12-12,220,249,8,257,88.07,68
Trapped with Jester,2022-10-10,15,398,19,417,88.06,4
King of the Hat,2022-10-21,27,135,1,136,88.06,0
NEBULOUS: Fleet Command,2022-02-11,1133,1706,139,1845,88.05,167
Epic Battle Fantasy Collection,2022-05-30,219,216,6,222,88.01,4
Orc Massage,2022-02-09,1723,4994,489,5483,88.0,49
Cats and the Other Lives,2022-11-21,113,647,40,687,88.0,3
Chessformer,2022-01-18,29,133,1,134,88.0,1
Miss Neko 3,2022-12-18,388,1323,103,1426,87.97,22
Circadian Dice,2022-07-11,360,429,22,451,87.96,5
Nobody Saves the World,2022-01-18,3517,3710,352,4062,87.95,128
Burnhouse Lane,2022-12-02,133,451,24,475,87.92,10
Bakso Simulator,2022-10-08,1204,1177,90,1267,87.9,28
Card Shark,2022-06-02,1017,1700,142,1842,87.89,12
Mago,2022-06-21,115,484,27,511,87.88,4
Fishing Vacation,2022-04-21,9,129,1,130,87.88,0
Ctrl Alt Ego,2022-07-22,37,294,12,306,87.86,5
Dome Keeper,2022-09-27,6883,5828,593,6421,87.85,546
Golden Light,2022-03-11,160,1982,172,2154,87.85,12
Crystal Project,2022-03-31,825,1392,112,1504,87.85,30
APICO,2022-05-20,645,719,48,767,87.82,32
JUSTICE SUCKS,2022-09-08,30,127,1,128,87.82,4
7 Days to End with You,2022-02-06,628,827,58,885,87.81,31
東方花映塚 ～ Phantasmagoria of Flower View.,2022-04-25,134,161,3,164,87.81,5
The Forest of Drizzling Rain,2022-11-16,134,161,3,164,87.81,7
Syberia - The World Before,2022-03-18,1302,2286,205,2491,87.8,128
Dimension Tripper Neptune: TOP NEP,2022-01-20,58,368,18,386,87.8,2
Mad Adventures,2022-11-22,647,813,57,870,87.79,7
100 hidden turtles,2022-09-04,8,176,4,180,87.79,0
100 hidden hares,2022-06-10,8,143,2,145,87.77,0
You Will (Not) Remain,2022-01-07,137,1805,156,1961,87.75,2
PomoFarm,2022-07-05,92,174,4,178,87.73,53
Occupy White Walls,2022-07-08,163,1136,89,1225,87.71,10
The Price Of Flesh,2022-05-02,178,259,10,269,87.7,16
Mr. Rainer's Solve-It Service,2022-02-21,79,188,5,193,87.7,0
ZERO Sievert,2022-11-15,6136,5876,612,6488,87.68,373
PRODUCER (2021),2022-11-14,10,104,0,104,87.68,0
NEO: The World Ends with You,2022-10-19,258,444,25,469,87.66,53
The Heilwald Loophole,2022-02-04,11,139,2,141,87.65,0
NEKO-MIMI SWEET HOUSEMATES Vol. 1,2022-04-08,61,214,7,221,87.62,0
Banana Drama,2022-07-25,48,199,6,205,87.61,0
Medieval Fantasy Survival Simulator,2022-02-25,9,227,8,235,87.6,0
Backpack Hero,2022-08-15,3627,2855,274,3129,87.59,436
Jack Move: I.C.E Breaker,2022-05-19,332,519,32,551,87.59,0
Buck Up And Drive!,2022-01-10,83,508,31,539,87.59,10
Prose & Codes,2022-02-11,22,120,1,121,87.59,1
Polda 7,2022-04-14,618,541,34,575,87.58,16
CRISIS CORE –FINAL FANTASY VII– REUNION,2022-12-13,9648,3515,350,3865,87.54,314
The Neverland of the Mountain and Sea,2022-12-19,45,167,4,171,87.54,0
יום פתוח,2022-06-22,41,100,0,100,87.54,0
Psycho地雷InLove : 싸이코지라이 인 러브,2022-06-08,30,210,7,217,87.53,2
FINAL FANTASY VII REMAKE INTERGRADE,2022-06-17,13803,12817,1464,14281,87.52,"1,579"
Perfect Tides,2022-02-22,31,151,3,154,87.52,1
Different Strokes,2022-11-10,156,811,60,871,87.5,16
Hardspace: Shipbreaker,2022-05-25,7731,14336,1657,15993,87.49,359
镇邪 Zhenxie,2022-11-04,2379,1978,181,2159,87.49,59
Nightmare Frames,2022-06-16,25,150,3,153,87.49,0
Tina & Rook! Cookie Quest!,2022-08-19,16,134,2,136,87.49,0
Hell Pie,2022-07-21,276,662,46,708,87.47,8
Bear and Breakfast,2022-07-28,3027,3071,303,3374,87.46,92
Arcadie: Second-Born,2022-12-09,240,207,7,214,87.45,7
Gordian Quest,2022-06-23,1913,4529,472,5001,87.44,144
Fashion Police Squad,2022-08-15,142,517,33,550,87.42,3
Once Again,2022-10-03,32,473,29,502,87.42,6
Madohi Shiroki no Kamikakushi,2022-02-04,210,297,14,311,87.42,1
Hooked on You: A Dead by Daylight Dating Sim™,2022-08-03,4382,4715,496,5211,87.4,17
山：临界幸存者,2022-08-01,138,355,19,374,87.38,3
MareQuest,2022-12-01,46,231,9,240,87.38,3
白色哀悼：灰域美术馆,2022-12-18,33,176,5,181,87.38,2
Blood West,2022-02-10,250,1420,124,1544,87.37,30
Haiku the Robot,2022-04-28,410,1352,117,1469,87.36,10
Tumbleweed Destiny,2022-04-01,429,306,15,321,87.36,12
Time Thief,2022-05-25,12,161,4,165,87.36,0
Time Thief,2022-05-25,12,161,4,165,87.36,0
Time Thief,2022-12-28,2,6,1,7,66.62,0
Time Thief,2022-12-28,2,6,1,7,66.62,0
幻恋の夜宴: ハルーシサノバこいし ~ Halluci-Sabbat of Koishi,2022-01-07,51,216,8,224,87.34,2
ヘブンバーンズレッド,2022-08-10,20201,2307,222,2529,87.33,"4,454"
The Monster Breeder,2022-01-19,81,94,0,94,87.31,2
Re-Volt,2022-07-29,250,830,64,894,87.3,14
李雷和韩梅梅,2022-03-31,88,397,23,420,87.3,1
Deadlink,2022-10-18,270,788,60,848,87.29,23
Hidden Cats in Paris,2022-03-31,11,253,11,264,87.29,0
Otome * Domain,2022-12-23,92,187,6,193,87.29,13
Trash Horror Collection,2022-06-17,19,277,13,290,87.27,1
Socialism Simulator,2022-09-09,17,172,5,177,87.26,1
Orb of Creation,2022-03-31,1152,683,50,733,87.25,72
Terror of Hemasaurus,2022-10-17,170,426,26,452,87.23,4
Police Stories: The Academy,2022-08-02,282,801,62,863,87.22,24
そろそろ寿司を食べないと死ぬぜ！,2022-06-21,28,126,2,128,87.22,2
TOMOMI,2022-03-25,15,92,0,92,87.22,2
DEEP FOG,2022-04-29,17,92,0,92,87.22,0
Urbek City Builder,2022-07-13,665,889,71,960,87.21,74
嗜血印 Bloody Spell,2022-01-26,7267,25909,3215,29124,87.2,213
Hatsune Miku Logic Paint S,2022-11-19,237,522,35,557,87.2,28
Cosmonious High,2022-03-31,80,184,6,190,87.2,13
Trimps,2022-05-02,3865,766,59,825,87.18,"1,108"
SpiderHeck,2022-09-22,3011,2648,266,2914,87.17,360
TimeShifters,2022-06-01,15,108,1,109,87.16,0
Sakura Hime 3,2022-12-16,88,247,11,258,87.15,4
Space Beast Terror Fright,2022-06-04,149,1362,122,1484,87.14,5
V Rising,2022-05-17,150645,54573,7093,61666,87.11,"7,764"
Rush Rally 3,2022-11-24,59,194,7,201,87.11,14
からぱりうぉーず,2022-05-27,90,167,5,172,87.11,5
FUCK HITLER,2022-11-30,204,2634,267,2901,87.1,61
FUCK PUTIN,2022-04-13,246,4907,539,5446,87.09,43
Karambola,2022-06-16,16,218,9,227,87.06,0
Memory Lost: Chapter One,2022-12-01,4299,165,5,170,87.05,0
The Wandering Village,2022-09-14,5786,3076,321,3397,87.04,136
Plants vs. Zombies™ Garden Warfare 2: Deluxe Edition,2022-05-16,4888,9634,1137,10771,87.03,"1,010"
Ballads at Midnight,2022-07-15,31,217,9,226,87.03,3
Galaxy Life,2022-08-31,4741,5072,565,5637,87.01,"1,004"
咸鱼喵喵,2022-08-05,510,650,49,699,87.01,5
Garden of the Sea,2022-01-13,72,528,37,565,87.0,2
Jabroni Brawl: Episode 3,2022-11-11,651,1052,91,1143,86.99,10
Sail Forth,2022-12-21,170,288,15,303,86.99,1
幸福的二人房,2022-09-29,670,1690,162,1852,86.97,23
OlliOlli World,2022-02-07,403,1057,92,1149,86.96,24
Astral Ascent,2022-04-12,382,935,79,1014,86.96,87
Pewt 'em Up!,2022-06-08,44,134,3,137,86.96,1
Chicken Invaders Universe,2022-12-15,420,2053,204,2257,86.95,192
Tap Ninja,2022-03-17,3387,4614,513,5127,86.94,"3,011"
SCP : Secret Files,2022-09-13,927,2793,292,3085,86.93,11
The Longest Walk,2022-09-09,11,273,14,287,86.92,0
Space Tail: Lost in the Sands,2022-08-12,77,161,5,166,86.92,0
CrushBorgs,2022-06-10,18,118,2,120,86.92,0
King of Retail,2022-09-14,1079,2755,288,3043,86.91,171
Prognostic,2022-05-19,43,352,21,373,86.91,1
Retro Gadgets,2022-11-30,124,186,7,193,86.88,7
Neighbor Fight,2022-06-09,24,117,2,119,86.88,4
Wee Tanks!,2022-02-23,97,271,14,285,86.87,2
Mount & Blade II: Bannerlord,2022-10-25,248216,192573,26841,219414,86.84,"25,849"
Knightfall: A Daring Journey,2022-04-01,3328,4963,563,5526,86.84,1
RUNGORE: Beginner Experience,2022-09-02,862,684,54,738,86.84,3
Tandis,2022-04-21,40,116,2,118,86.84,0
RUN: The world in-between,2022-04-14,78,116,2,118,86.84,5
Duck Paradox,2022-07-19,48,222,10,232,86.83,0
Shirone: the Dragon Girl,2022-03-10,27,83,0,83,86.83,2
As Dusk Falls,2022-07-19,300,1477,141,1618,86.82,23
Sakura Hime 2,2022-04-22,150,653,51,704,86.82,2
Touhou Crisis,2022-05-26,10,184,7,191,86.82,0
Dread Delusion,2022-06-15,117,563,42,605,86.8,13
Oxygen: First Breath,2022-10-07,968,1167,107,1274,86.77,31
UNCHARTED™: Legacy of Thieves Collection,2022-10-19,10851,11037,1357,12394,86.76,"1,236"
Crypt,2022-09-27,234,958,84,1042,86.76,1
Crypt,2022-09-27,234,958,84,1042,86.76,0
Crypt,2018-03-09,28,103,34,137,69.47,1
Crypt,2018-03-09,28,103,34,137,69.47,0
VenusBlood HOLLOW International,2022-01-07,343,207,9,216,86.76,14
Sekai to Sekai no Mannaka de,2022-02-11,70,156,5,161,86.76,0
Immortal Mantis,2022-04-22,10,156,5,161,86.76,0
9-nine-:NewEpisode,2022-03-18,85,288,16,304,86.74,1
Beat Invaders,2022-03-10,23,142,4,146,86.74,0
In The Rural Village of Nagoro,2022-11-08,12,218,10,228,86.73,0
High On Life,2022-12-13,11608,8514,1034,9548,86.69,320
Melody's Escape 2,2022-09-30,70,167,6,173,86.69,1
Psycho Bathroom,2022-04-29,655,112,2,114,86.68,0
OxU,2022-09-22,11,80,0,80,86.68,1
Drift racing car,2022-09-29,412,140,4,144,86.67,34
Squad 51 vs. the Flying Saucers,2022-09-21,22,126,3,129,86.66,2
GigaBash,2022-08-04,305,686,56,742,86.65,18
Ponchoman,2022-03-15,11,96,1,97,86.65,0
Grounded,2022-09-27,32012,48533,6580,55113,86.64,"5,934"
Just King,2022-07-21,1247,932,83,1015,86.62,28
Mayonnaise Simulator,2022-05-13,12,165,6,171,86.62,0
纸嫁衣3鸳鸯债,2022-09-29,655,519,39,558,86.61,14
Cursed 3,2022-10-26,35,95,1,96,86.61,1
Temperia: Soul of Majestic,2022-07-26,1258,746,63,809,86.59,0
Beat Hazard 3,2022-11-14,107,213,10,223,86.59,3
My Therapy,2022-08-11,22,236,12,248,86.58,0
SurrounDead,2022-06-24,511,2405,258,2663,86.56,115
封神榜2022,2022-01-06,119,807,70,877,86.56,1
WasteLand Express 废土快递,2022-10-28,472,743,63,806,86.56,41
I commissioned some bees,2022-05-30,16,163,6,169,86.55,1
東方眠世界 ~ Wonderful Waking World,2022-06-15,29,150,5,155,86.55,2
Lost Nova,2022-05-11,130,256,14,270,86.52,4
HomeWind,2022-03-10,189,608,49,657,86.51,8
Ozymandias,2022-10-11,1032,645,53,698,86.5,99
Harmony's Odyssey,2022-10-19,30,174,7,181,86.5,6
CHAOS;HEAD NOAH,2022-10-07,238,319,20,339,86.47,35
Force Reboot,2022-08-25,25,276,16,292,86.47,2
Lust Theory,2022-03-19,1417,2818,313,3131,86.46,156
BLOWFLY,2022-10-27,65,92,1,93,86.46,0
Devil Spire,2022-02-02,50,231,12,243,86.45,1
Impaler,2022-12-06,39,264,15,279,86.44,8
We Who Are About To Die,2022-11-14,2266,3448,394,3842,86.43,123
Just Act Natural,2022-03-25,855,3364,384,3748,86.42,105
Island Cities,2022-08-30,20,106,2,108,86.42,1
Once Upon a Jester,2022-11-09,26,75,0,75,86.42,0
Kharon's Crypt - Even Death May Die,2022-02-01,20,91,1,92,86.41,0
沙盒勇者：序章,2022-03-08,77,146,5,151,86.4,1
Impact Point,2022-07-20,283,924,85,1009,86.39,18
Doors: Paradox,2022-11-04,341,455,34,489,86.38,6
发糖模拟器,2022-10-21,238,304,19,323,86.38,6
HAAK,2022-08-25,898,1633,169,1802,86.37,100
聖石傳說EX,2022-03-11,313,261,15,276,86.37,1
Gunvein,2022-11-11,38,105,2,107,86.37,0
Gods of Sand,2022-02-07,135,415,30,445,86.36,5
Seventh Lair,2022-03-31,43,205,10,215,86.36,2
Yakiniku Simulation,2022-06-03,137,271,16,287,86.35,1
Tuition Academia,2022-02-22,180,249,14,263,86.34,6
Gibbon: Beyond the Trees,2022-05-18,44,238,13,251,86.34,1
Our way down,2022-03-31,26,157,6,163,86.34,0
Dreamin' Her - 僕は、彼女の夢を見る。-,2022-04-28,54,104,2,106,86.33,1
Voodoo Detective,2022-05-24,29,144,5,149,86.32,0
融雪,2022-09-30,262,853,78,931,86.31,14
Entropy,2022-02-02,7,117,3,120,86.29,0
和你相遇的那天是轮回高校的日常这也是合理的吗？,2022-03-03,33,117,3,120,86.29,0
Line Path,2022-05-26,13,117,3,120,86.29,1
Potionomics,2022-10-17,5170,3599,421,4020,86.28,110
Cat Museum,2022-03-17,74,506,40,546,86.28,0
Drums Rock,2022-06-02,16,155,6,161,86.27,3
KoboldKare,2022-12-15,470,802,73,875,86.24,112
Spirits of the Hellements,2022-04-28,252,256,15,271,86.24,5
Neophyte,2022-08-31,385,426,32,458,86.22,35
Guild Wars 2,2022-08-23,8324,7609,969,8578,86.17,"4,995"
FINAL FANTASY VI,2022-02-23,4556,2153,239,2392,86.16,179
FINAL FANTASY VI,2022-02-23,4556,2153,239,2392,86.16,22
FINAL FANTASY VI,2015-12-16,577,2010,435,2445,79.13,179
FINAL FANTASY VI,2015-12-16,577,2010,435,2445,79.13,22
Garage: Bad Dream Adventure,2022-07-07,98,127,4,131,86.15,3
The RPG Engine,2022-01-06,26,114,3,117,86.15,5
The Classrooms,2022-10-29,15,100,2,102,86.14,3
Camp Buddy: Scoutmaster Season,2022-08-04,58,139,5,144,86.13,16
They Don't Sleep,2022-09-14,28,139,5,144,86.13,0
Winkeltje: The Little Shop,2022-04-22,940,1230,125,1355,86.12,25
Dungeons of Dreadrock,2022-03-15,12,208,11,219,86.11,0
Regular Factory: Escape Room,2022-04-13,51,126,4,130,86.11,1
Time Rift,2022-02-17,15,113,3,116,86.11,0
Escape From Mandrillia,2022-07-18,28,85,1,86,86.11,1
Crustacean Nations,2022-08-19,84,240,14,254,86.1,13
FIND ALL 3: Travel,2022-07-21,55,185,9,194,86.09,4
Sophstar,2022-02-18,32,69,0,69,86.08,0
MineSweeper Tetris,2022-12-15,51,217,12,229,86.05,9
Fursan al-Aqsa: The Knights of the Al-Aqsa Mosque,2022-04-18,11,161,7,168,86.05,0
Beyond The Edge Of Owlsgard,2022-12-23,28,84,1,85,86.05,1
Fallen Arena,2022-12-23,87,1493,159,1652,86.04,1
Espresso Tycoon Prologue: Underwater,2022-11-04,323,509,42,551,86.04,10
LUL Inc.,2022-01-14,26,98,2,100,86.04,1
Quasimorphosis,2022-03-02,143,279,18,297,86.03,2
Deisim,2022-09-01,37,589,51,640,86.02,3
Curse Crackers: For Whom the Belle Toils,2022-08-31,22,111,3,114,86.01,7
TRATRITLE,2022-07-16,456,451,36,487,86.0,7
MONSTER CARDS,2022-08-12,78,148,6,154,86.0,18
求闻编年史 ～ Gensokyo Recollection,2022-08-23,30,83,1,84,86.0,7
U-ena -遠花火の少女-,2022-05-08,99,394,30,424,85.98,5
书之旅人 Story Walker,2022-08-12,15,123,4,127,85.98,0
FOONDA,2022-05-06,32,97,2,99,85.98,0
たすけて！おつかれさとり様,2022-03-08,46,558,48,606,85.97,2
The Last Cube,2022-03-10,47,110,3,113,85.97,0
Red Matter 2,2022-08-18,75,266,17,283,85.96,5
Muv-Luv Alternative Total Eclipse,2022-07-21,117,135,5,140,85.96,3
Baldwin's Bear,2022-04-01,10,67,0,67,85.96,0
Repella Fella: Prologue,2022-11-18,12,67,0,67,85.96,0
Flight Of Nova,2022-05-31,75,181,9,190,85.95,42
Gedonia,2022-10-14,1331,2335,270,2605,85.92,68
Trash Bomber,2022-07-18,36,146,6,152,85.92,0
KEEK,2022-08-18,27,109,3,112,85.92,0
Expeditions: Rome,2022-01-20,9765,3610,441,4051,85.91,325
Clanfolk,2022-07-14,2784,1494,162,1656,85.9,358
memoir,2022-06-03,13,157,7,164,85.9,0
Withering Rooms,2022-10-04,13,66,0,66,85.9,1
ADACA,2022-07-26,131,398,31,429,85.88,8
卖萌恶霸喵霸霸 Cute Bully Nyanbaba,2022-09-16,8,81,1,82,85.88,0
LumbearJack,2022-06-11,30,81,1,82,85.88,0
Like Dreamer,2022-07-21,25,81,1,82,85.88,0
Panzer Arena: Prologue,2022-09-16,16,81,1,82,85.88,0
Zombie Apocalypse Survival Simulator,2022-10-17,5,81,1,82,85.88,0
Skinwalker Hunt,2022-08-19,62,585,52,637,85.85,2
Climbey,2022-01-08,69,1027,105,1132,85.82,5
PANELKI,2022-03-04,43,395,31,426,85.82,14
Justin Wack and the Big Time Hack,2022-08-23,30,107,3,110,85.82,3
天天地下城,2022-01-13,4,107,3,110,85.82,0
Higurashi When They Cry Hou - Rei,2022-06-02,29,107,3,110,85.82,1
Trust No Bunny,2022-09-13,67,107,3,110,85.82,10
Graveyard Girls,2022-09-30,8,80,1,81,85.82,0
Beach Island Deluxe,2022-08-27,30,166,8,174,85.81,0
PowerSlave Exhumed,2022-02-10,237,466,39,505,85.79,4
System Purge,2022-04-05,7,119,4,123,85.79,0
Cat's Kiss,2022-05-27,175,1317,142,1459,85.78,14
Lootun,2022-08-31,519,239,15,254,85.78,64
With You,2022-02-02,91,1512,167,1679,85.77,11
Midnight Fight Express,2022-08-23,783,1093,114,1207,85.77,17
萝莉的远征,2022-01-15,57,176,9,185,85.77,5
月出之时,2022-04-20,9,64,0,64,85.77,0
Voltage High Society,2022-07-27,6,64,0,64,85.77,0
江湖幸存者,2022-12-28,847,639,59,698,85.76,182
We Are One Prologue,2022-02-09,10,79,1,80,85.76,0
Starship Troopers: Terran Command,2022-06-16,8163,6501,855,7356,85.75,275
Deducto,2022-02-10,752,2410,286,2696,85.74,71
We Are OFK,2022-08-18,36,153,7,160,85.74,2
Star Valor,2022-08-03,1891,1836,210,2046,85.73,265
The Bridge Curse Road to Salvation,2022-08-25,1251,1498,166,1664,85.73,30
CatNab,2022-03-14,15,92,2,94,85.72,0
Obama Maze,2022-08-01,46,893,90,983,85.71,2
夏恋幻梦,2022-08-19,41,152,7,159,85.7,1
Easy Red 2,2022-01-06,242,2348,280,2628,85.67,75
纸嫁衣2奘铃村,2022-05-06,738,691,66,757,85.67,10
东方异乡录 ~the Apocryphal Gensoukyou,2022-09-30,24,162,8,170,85.66,0
Margo,2022-12-27,21,162,8,170,85.66,0
Love of Magic Book 2: The War,2022-05-31,86,91,2,93,85.66,6
INCISION,2022-09-16,55,368,29,397,85.65,4
Owlone in the Woods,2022-01-06,29,116,4,120,85.65,0
少女妖精弹珠台 Elf Girl Pinball,2022-11-30,124,283,20,303,85.64,2
Super Dungeon Maker,2022-02-15,68,264,18,282,85.64,6
Dino Nest,2022-04-28,45,193,11,204,85.62,2
The Plague Doctor of Wippra,2022-10-05,22,150,7,157,85.62,0
Splatter,2022-12-15,21,103,3,106,85.62,0
Paradiddle,2022-11-02,34,384,31,415,85.61,5
Title_Pending,2022-09-27,36,182,10,192,85.6,0
Lord Winklebottom Investigates,2022-07-28,36,115,4,119,85.6,0
Escape the Backrooms,2022-08-11,3301,14332,2028,16360,85.58,"1,712"
Mini Pipes,2022-04-18,15,61,0,61,85.57,0
Legend of the Outlaw Mage,2022-02-18,28,251,17,268,85.55,0
This Way Madness Lies,2022-11-10,41,89,2,91,85.55,1
Tailbound,2022-09-12,25,159,8,167,85.54,3
Unsolved Case,2022-11-24,1087,2012,239,2251,85.53,207
MARVEL SNAP,2022-10-18,11670,11225,1574,12799,85.51,"6,360"
Catto Pew Pew!,2022-08-16,127,620,59,679,85.51,6
Warlord: Britannia,2022-05-25,379,990,105,1095,85.5,42
Princess Farmer,2022-03-31,22,113,4,117,85.5,1
Plot of the Druid,2022-11-01,9,60,0,60,85.49,2
Meet me at NooN,2022-06-21,13,60,0,60,85.49,0
Conrad Stevenson's Paranormal P.I.,2022-02-28,66,517,47,564,85.48,8
Bombergrounds: Reborn,2022-10-06,1945,7003,954,7957,85.47,97
The House of Da Vinci 3,2022-12-23,338,341,27,368,85.46,53
Capcom Fighting Collection,2022-06-24,828,464,41,505,85.45,38
东方心之解束~Saving from the devil,2022-07-12,27,74,1,75,85.45,0
Warpips,2022-04-21,2136,3008,380,3388,85.43,56
LASER LAB,2022-09-08,30,177,10,187,85.42,1
Para Eyes,2022-10-25,17,59,0,59,85.42,13
Save the Reactor,2022-05-11,20,59,0,59,85.42,1
真空战姬,2022-07-11,23,134,6,140,85.41,0
EZ2ON REBOOT : R,2022-04-14,2768,4262,560,4822,85.4,130
Heaven Dust 2,2022-01-06,651,554,52,606,85.4,7
Void Scrappers,2022-10-21,353,347,28,375,85.4,6
House Party,2022-07-16,1800,11734,1671,13405,85.39,195
My Time at Sandrock,2022-05-26,21778,10799,1531,12330,85.38,"4,779"
你已经猜到结局了吗,2022-07-15,141,216,14,230,85.38,8
Songs of Conquest,2022-05-10,4192,4511,598,5109,85.37,398
Demon Turf: Neon Splash,2022-04-14,22,110,4,114,85.35,0
ケチャップandマヨネーズ,2022-04-10,23,58,0,58,85.35,0
Football Manager 2023,2022-11-08,83715,10106,1432,11538,85.34,"75,753"
Project Sparrow,2022-03-11,575,1042,114,1156,85.34,0
双相,2022-11-17,51,205,13,218,85.34,4
Bingus: My Beloved,2022-11-18,14,72,1,73,85.32,1
MultiVersus,2022-07-19,153433,80992,12666,93658,85.31,270
WTF Do You Know?,2022-05-02,10,109,4,113,85.29,0
BLACK SHEEP TOWN,2022-09-15,152,71,1,72,85.25,8
MONSTER HUNTER RISE,2022-01-12,231360,61237,9565,70802,85.23,"18,330"
Antimatter Dimensions,2022-12-17,6962,1248,143,1391,85.23,"2,643"
HBDIE: The Nonce 2,2022-08-05,34,656,66,722,85.23,0
Temp Zero,2022-04-29,20,119,5,124,85.22,0
Putinist Slayer,2022-08-22,4,56,0,56,85.2,0
Nekomancy,2022-09-01,11,56,0,56,85.2,0
Mage and Monsters,2022-10-12,528,491,46,537,85.19,32
The Final Earth 2,2022-07-15,51,107,4,111,85.19,6
Mega Mall Story,2022-07-04,62,107,4,111,85.19,1
Toilet Chronicles,2022-07-14,162,746,78,824,85.17,3
Dissonance,2022-04-27,20,129,6,135,85.17,0
Grandpa's Cheese,2022-05-14,55,118,5,123,85.17,0
花都之恋,2022-04-27,13,118,5,123,85.17,0
Super Psycho Baseball,2022-12-20,41,118,5,123,85.17,2
Antivine,2022-12-21,13,95,3,98,85.17,1
Submerged: Hidden Depths,2022-03-09,41,228,16,244,85.15,3
Stardeus,2022-10-12,2139,714,75,789,85.06,74
琳琳,2022-11-11,22,81,2,83,85.05,1
Crysis 2 Remastered,2022-11-17,863,1879,234,2113,85.04,248
混世萌王喵霸霸 Cute Chaos Demon Nyanbaba,2022-09-21,6,54,0,54,85.04,0
Sokobos,2022-04-01,6,54,0,54,85.04,0
我的猫娘恋人 My Cat Girl Lover,2022-08-15,26,167,10,177,85.03,3
LEGO® Bricktales,2022-10-12,739,481,46,527,85.02,26
Sex and the Furry Titty 2: Sins of the City,2022-09-08,219,407,37,444,85.02,10
Dark Nights,2022-11-01,39,104,4,108,85.02,25
RGB Rush,2022-04-20,29,115,5,120,85.01,1
Lorn's Lure: Prologue,2022-03-11,18,176,11,187,85.0,0
AI: THE SOMNIUM FILES - nirvanA Initiative,2022-06-24,2845,1813,226,2039,84.99,76
ＲＰＧタイム！～ライトの伝説～,2022-09-13,72,166,10,176,84.99,4
Vox Machinae,2022-05-13,110,1017,116,1133,84.98,3
Over the Counter,2022-02-13,85,232,17,249,84.98,0
EndCycle VS,2022-04-20,18,80,2,82,84.98,0
Cavity Busters,2022-03-18,14,80,2,82,84.98,0
Queen of the flies 蝇后,2022-03-31,9,213,15,228,84.96,0
原灵·深海遗梦 Medusa the Origin ~ Lost Dream of the Deep,2022-03-27,45,103,4,107,84.96,0
Cute Cats 3,2022-05-25,6,103,4,107,84.96,1
Dice Tribes: Ambitions,2022-06-15,49,67,1,68,84.96,2
The Elder Scrolls II: Daggerfall,2022-04-26,535,1628,201,1829,84.95,37
Sqroma,2022-02-28,9,53,0,53,84.95,0
Ultimate Epic Battle Simulator 2,2022-05-12,1802,2860,379,3239,84.94,173
WARRIORS OROCHI 3 Ultimate Definitive Edition,2022-07-12,2996,1298,155,1453,84.94,142
RiffTrax: The Game,2022-05-05,120,155,9,164,84.94,1
The Use of Life,2022-05-21,176,284,23,307,84.93,3
NecroBouncer: Prologue,2022-10-13,419,193,13,206,84.92,2
Please Touch The Artwork,2022-01-26,12,124,6,130,84.92,0
Frozen Memories,2022-03-12,11,79,2,81,84.92,0
Chronicles of Tal'Dun: The Remainder,2022-03-23,10,79,2,81,84.92,1
Necrosmith,2022-07-13,4498,3378,457,3835,84.91,235
Gilded Shadows,2022-05-13,138,113,5,118,84.91,34
Atari 50: The Anniversary Celebration,2022-11-11,76,144,8,152,84.9,3
Settlement Survival,2022-10-24,5613,4843,679,5522,84.89,760
Smasher and the Will o' the Thiccs,2022-07-12,14,66,1,67,84.89,0
Dungeon Master,2022-09-29,23,400,37,437,84.88,1
Eternal Edge Plus Prologue,2022-05-05,572,1317,159,1476,84.87,2
你画我拼You draw I puzzle,2022-02-21,12,52,0,52,84.87,0
Aery - A New Frontier,2022-05-13,4,52,0,52,84.87,0
起飞吧！兔兔,2022-06-30,8,52,0,52,84.87,0
Spellbook Demonslayers Prologue,2022-08-03,862,504,50,554,84.86,0
Reloader: test_subject,2022-01-14,23,210,15,225,84.86,0
CozyTyper,2022-07-22,39,112,5,117,84.85,1
CosmoOdyssey:Trip to Mars,2022-08-18,4,78,2,80,84.85,0
Home Behind 2,2022-02-16,20081,5619,801,6420,84.84,183
THE BUTTON,2022-04-27,438,1363,166,1529,84.84,6
Nitro Kid,2022-10-18,155,236,18,254,84.82,14
Dead Grid,2022-03-24,194,227,17,244,84.82,4
Coromon,2022-03-31,4026,3314,452,3766,84.81,140
TRYP FPV,2022-06-30,234,732,80,812,84.81,104
Yes My Lord,2022-09-16,73,89,3,92,84.8,2
I Live Under Your House,2022-10-31,9,89,3,92,84.8,0
Ruza,2022-11-11,26,89,3,92,84.8,0
Warhammer 40000: Shootas Blood & Teef,2022-10-20,932,1385,170,1555,84.79,11
INPUT6,2022-12-23,17,111,5,116,84.79,0
Pickle Clicker,2022-05-03,59,700,76,776,84.78,3
Andro Dunos 2,2022-03-25,10,77,2,79,84.78,0
Quadrata,2022-10-10,15,77,2,79,84.78,0
Pair Of Stamps,2022-11-25,11,51,0,51,84.78,0
Escape Memoirs: Mini Stories,2022-09-30,2987,2206,289,2495,84.77,186
Cross Concerto,2022-09-23,111,189,13,202,84.76,1
Blacktop Hoops,2022-04-19,30,434,42,476,84.74,4
SUKEBE BLOCKS,2022-03-03,18,110,5,115,84.74,0
Cute Cats 2,2022-04-01,7,88,3,91,84.73,0
HimeYoku: A Sacrifice of Lust and Grace,2022-09-09,68,88,3,91,84.73,7
Five Stages of Pink,2022-04-29,10,64,1,65,84.73,0
The Caligula Effect 2,2022-06-23,297,259,21,280,84.72,4
Outdoor Adventures With Marisa Kirisame,2022-03-01,5,76,2,78,84.7,1
QUICKERFLAK,2022-01-12,19,187,13,200,84.69,0
Making Lovers After Stories,2022-08-26,35,50,0,50,84.69,0
Kitty Ball,2022-04-19,35,168,11,179,84.67,0
Nomad Survival,2022-10-09,2431,1366,170,1536,84.66,92
Karisvale,2022-04-01,17,139,8,147,84.66,0
"""LIFE"" not found;",2022-06-23,6,87,3,90,84.66,0
Magic Axolotl,2022-10-28,5,63,1,64,84.65,0
Meteor World Actor: Badge & Dagger,2022-06-10,125,213,16,229,84.64,1
Obama,2022-01-20,83,799,91,890,84.63,0
The Journey - Episode 2: Words of Wisdom,2022-06-06,8,75,2,77,84.63,0
シャルドネロマンシア,2022-04-25,213,108,5,113,84.62,0
Sunday Gold: Prologue,2022-08-10,19,108,5,113,84.62,0
Graphwar,2022-02-23,124,339,31,370,84.61,3
躲猫猫,2022-11-13,21,138,8,146,84.61,0
Mothmen 1966,2022-07-14,22,157,10,167,84.6,0
Rush Rally Origins,2022-04-13,18,128,7,135,84.6,0
KamiYaba: Destiny on a Dicey Deadline,2022-01-28,21,97,4,101,84.6,11
G-Darius HD,2022-03-30,56,86,3,89,84.6,2
---Red---Tether-->,2022-01-18,28,49,0,49,84.6,0
Meowjiro,2022-11-08,200,394,38,432,84.58,6
One Dreamer,2022-09-09,103,246,20,266,84.58,2
SPEARHEAD,2022-05-14,12,62,1,63,84.57,0
TAPE: Unveil the Memories,2022-04-13,15,62,1,63,84.57,0
Chess Survivors,2022-11-10,20,62,1,63,84.57,0
Super Alloy Ranger,2022-09-15,47,155,10,165,84.51,6
World Racing 2,2022-12-08,51,136,8,144,84.51,3
The Elevator Game with Catgirls,2022-12-13,10,48,0,48,84.51,0
Nomori: Prologue,2022-08-17,13,106,5,111,84.5,1
Crysis 3 Remastered,2022-11-17,492,1473,189,1662,84.49,193
Yumahorome ~Toki o Tometa Yakata de Asu o Sagasu Maigo-tachi~,2022-08-12,131,200,15,215,84.49,4
Epiphany City,2022-04-12,74,182,13,195,84.49,1
Rail Route: The Story of Jozic,2022-06-21,34,73,2,75,84.48,7
Elec Dude,2022-03-02,7,73,2,75,84.48,0
Ero Manager,2022-03-11,91,242,20,262,84.45,1
Siren's Call,2022-04-15,25,163,11,174,84.45,0
Blazing Aries,2022-03-12,180,216,17,233,84.44,2
The Unluckiest Man,2022-10-27,18,144,9,153,84.43,0
RUKIMIN's Disappointing Adventure!,2022-05-23,66,258,22,280,84.42,0
Vacant Kingdom,2022-10-06,14,47,0,47,84.41,0
Light Maze,2022-07-18,7,47,0,47,84.41,0
Sweety Kitty 2,2022-11-14,19,47,0,47,84.41,0
Logic Light,2022-01-26,6,60,1,61,84.4,0
BVOVB - Bruising Vengeance of the Vintage Boxer,2022-08-11,4,60,1,61,84.4,0
GRAND CROSS: ReNOVATION,2022-01-20,27,83,3,86,84.39,0
Ghost Watchers,2022-07-28,4747,9769,1513,11282,84.38,579
Pocket City,2022-08-22,26,114,6,120,84.38,4
Marble World,2022-09-30,124,633,71,704,84.37,43
街机三国志,2022-09-09,192,611,68,679,84.37,13
After the Inferno,2022-08-01,134,361,35,396,84.37,11
Sephonie,2022-04-12,36,170,12,182,84.36,3
Stranded: Alien Dawn,2022-10-12,5273,2589,361,2950,84.35,"1,707"
Yokai Art: Night Parade of One Hundred Demons,2022-09-29,251,506,54,560,84.35,40
Sunday Rivals,2022-05-16,23,205,16,221,84.35,1
Timeloop: Sink Again Beach,2022-11-16,11,142,9,151,84.33,1
Ralph and the Blue Ball,2022-10-11,6,71,2,73,84.32,0
Grand Mountain Adventure,2022-03-10,45,204,16,220,84.31,2
雨にして人を外れ,2022-10-13,24,82,3,85,84.31,0
120 Yen Stories,2022-01-28,9,59,1,60,84.31,1
Employee of the Month,2022-09-21,12,59,1,60,84.31,0
Unusual Findings,2022-10-12,123,254,22,276,84.3,3
The Jackbox Party Starter,2022-06-30,293,132,8,140,84.3,12
Monster Girls and the Mysterious Adventure 2,2022-08-26,558,212,17,229,84.29,60
Bonding Ambivalence,2022-10-26,42,186,14,200,84.29,6
Takoyaki Party Survival,2022-08-27,654,177,13,190,84.28,9
Goonect,2022-05-27,228,122,7,129,84.28,8
Tiny Combat Arena,2022-02-22,400,959,118,1077,84.27,3
Few Nights More,2022-04-28,99,92,4,96,84.27,2
NeverAwake,2022-09-28,53,102,5,107,84.25,0
Jelly Is Sticky,2022-05-19,27,70,2,72,84.24,0
Swordship,2022-12-05,18,70,2,72,84.24,0
Monster Girl Manager,2022-03-06,29,70,2,72,84.24,1
汉字大冒险,2022-12-17,46,58,1,59,84.22,0
What Lies in the Multiverse - Prologue,2022-01-25,6,58,1,59,84.22,0
Social Moth,2022-05-11,22,58,1,59,84.22,0
Dragon Drop,2022-06-11,10,45,0,45,84.21,0
Dragon Drop,2022-06-11,10,45,0,45,84.21,0
Dragon Drop,2017-11-09,4,7,0,7,73.26,0
Dragon Drop,2017-11-09,4,7,0,7,73.26,0
A Wholesome Game About Farming,2022-12-15,6,45,0,45,84.21,0
RUKIMIN's Disappointing Adventure! ~SHOBOMI AND THE PHANTOM RUINS~,2022-09-17,26,111,6,117,84.2,0
JoJo's Bizarre Adventure: All-Star Battle R,2022-09-01,7029,5446,825,6271,84.19,198
RESTLESS SOUL,2022-09-01,14,101,5,106,84.19,0
Jivana,2022-01-21,25,407,42,449,84.18,3
Creature Creator,2022-12-23,123,337,33,370,84.16,47
come see my hole,2022-10-27,25,120,7,127,84.16,2
Who Is The Red Queen?,2022-08-15,15,80,3,83,84.16,2
Volley Court,2022-11-26,111,69,2,71,84.16,13
Diluvian Winds Prologue,2022-09-21,283,352,35,387,84.15,4
Space Quest: 2099,2022-01-25,21,110,6,116,84.14,0
What if George Washington was a Girl?,2022-08-12,9,138,9,147,84.13,0
Egression,2022-10-12,16,57,1,58,84.13,0
Byte Lynx,2022-10-12,31,57,1,58,84.13,0
Bounty of One,2022-08-18,1648,1275,167,1442,84.12,379
Titan Station,2022-11-11,27,182,14,196,84.12,4
Abalon,2022-06-20,109,173,13,186,84.1,6
Triple Take,2022-10-06,10,44,0,44,84.1,0
Ringlorn Saga,2022-11-07,7,44,0,44,84.1,0
Azazel's Christmas Fable,2022-11-29,5,44,0,44,84.1,0
Sora no Ao to Shiro to,2022-11-04,38,146,10,156,84.08,1
Stardom,2022-03-31,159,68,2,70,84.08,6
I Fetch Rocks,2022-03-03,17,68,2,70,84.08,1
All Quiet Roads,2022-04-11,48,68,2,70,84.08,2
TOKOYO: The Tower of Perpetuity,2022-06-02,169,387,40,427,84.07,2
HipWitch,2022-02-04,18,99,5,104,84.06,0
Ashina: The Red Witch,2022-06-04,12,89,4,93,84.06,0
Game Dev Story,2022-03-28,286,511,57,568,84.05,11
Poker Quest,2022-11-14,281,475,52,527,84.05,31
Paradox of Hope,2022-09-15,109,423,45,468,84.04,5
Gretel and Winslow's Mansion,2022-01-19,231,197,16,213,84.04,1
Zetria,2022-06-10,300,653,77,730,84.03,8
Foretales,2022-09-15,628,474,52,526,84.03,33
DAGURI: Gambling Apocalypse,2022-10-14,61,56,1,57,84.03,0
Late Bird,2022-01-20,3,78,3,81,84.01,0
Vestaria Saga II: The Sacred Sword of Silvanister,2022-07-28,157,162,12,174,84.0,11
Let's Ride! Silver Buckle Stables,2022-01-28,11,43,0,43,84.0,2
A Walk With Yiayia,2022-11-03,4,43,0,43,84.0,0
How to Say Goodbye,2022-11-03,19,43,0,43,84.0,0
Galacticon,2022-05-20,12,43,0,43,84.0,0
Profession investigator,2022-07-13,8,43,0,43,84.0,0
Personal Space,2022-06-24,7,43,0,43,84.0,0
Personal Space,2022-06-24,7,43,0,43,84.0,0
Personal Space,2020-05-13,3,6,5,11,52.39,0
Personal Space,2020-05-13,3,6,5,11,52.39,0
My Name is Mayo 3,2022-05-17,27,117,7,124,83.99,1
Epics of Distant Realm: Holy Return,2022-03-16,8,117,7,124,83.99,0
Polygunners,2022-01-14,18,88,4,92,83.99,3
Sand Castle,2022-03-14,17,88,4,92,83.99,0
BroodStar,2022-06-15,9,67,2,69,83.99,1
Cool Kid Cody,2022-04-08,19,67,2,69,83.99,1
A Little to the Left,2022-11-08,1144,2104,298,2402,83.98,230
Vacuum Pilot,2022-10-30,38,153,11,164,83.98,1
女拳主義F-ist,2022-12-22,1156,1570,215,1785,83.97,17
Grapple Dog,2022-02-10,79,299,29,328,83.97,3
Meow Express,2022-01-07,45,228,20,248,83.97,0
The Odyssey of the Mammoth,2022-03-04,72,329,33,362,83.95,0
Chasm: The Rift,2022-10-10,100,178,14,192,83.95,1
SAOMI,2022-04-30,6,55,1,56,83.94,0
雛ちゃんブレイカー2ndBreak,2022-07-29,52,55,1,56,83.94,1
Aztlan Uncovered,2022-07-28,26,152,11,163,83.93,1
Blast Brigade vs. the Evil Legion of Dr. Cread,2022-04-13,49,169,13,182,83.92,3
Virtual Circuit Board,2022-05-20,49,134,9,143,83.92,5
Rise of the Third Power,2022-02-10,126,320,32,352,83.91,7
吞食天地2022,2022-09-30,124,357,37,394,83.9,1
Mago: The Villain's Burger,2022-02-07,280,566,66,632,83.88,0
Warstride Challenges,2022-04-19,95,151,11,162,83.88,0
依依,2022-03-26,8,151,11,162,83.88,0
Crate Mates,2022-02-25,11,42,0,42,83.88,1
There Swings a Skull: Grim Tidings,2022-09-15,5,42,0,42,83.88,0
Slaughter Horse 2,2022-12-05,13,42,0,42,83.88,1
MOONPONG: Tales of Epic Lunacy,2022-09-09,8,42,0,42,83.88,0
Ghost Exile,2022-01-07,476,1836,259,2095,83.87,134
Forgotten Realms: The Archives - Collection Two,2022-03-29,193,115,7,122,83.87,57
Ardor,2022-05-06,205,124,8,132,83.86,0
Watamari - A Match Made in Heaven Part1,2022-09-23,79,124,8,132,83.86,0
目盲/Blind,2022-11-26,124,522,60,582,83.85,4
Just A Humble Swordsmith,2022-07-09,44,436,48,484,83.85,0
Night Cascades,2022-03-01,14,76,3,79,83.85,0
GearCity,2022-01-14,289,1071,141,1212,83.84,35
sunny-place,2022-05-31,10,86,4,90,83.84,0
Regular Human Workshop,2022-09-24,75,362,38,400,83.83,42
Fungiman,2022-06-30,21,332,34,366,83.83,0
Prime of Flames,2022-12-15,550,714,88,802,83.82,50
MOTHERGUNSHIP: FORGE,2022-06-16,21,158,12,170,83.81,4
Kapia,2022-01-25,8,65,2,67,83.81,0
Guildford Castle VR,2022-03-24,11,65,2,67,83.81,0
选王之剑,2022-01-15,1325,1013,133,1146,83.79,36
DORAEMON STORY OF SEASONS: Friends of the Great Kingdom,2022-11-01,573,191,16,207,83.79,25
VTuber Connect,2022-11-21,17,95,5,100,83.78,0
COSPLAY LOVE! Enchanted princess,2022-03-30,9,41,0,41,83.77,0
Bocce Time!,2022-06-17,6,41,0,41,83.77,0
WikiArena,2022-10-25,13,41,0,41,83.77,0
Boots Quest DX,2022-11-25,7,41,0,41,83.77,0
To Be or Not to Be,2022-12-09,4559,2749,411,3160,83.72,224
NIGHT/SHADE: You're The Drug,2022-03-11,44,64,2,66,83.72,0
JANITOR BLEEDS,2022-04-07,24,156,12,168,83.71,0
Static of Eve –凝滯聖夜–,2022-07-11,34,74,3,77,83.68,0
non-binary,2022-07-19,16,180,15,195,83.67,0
Overloop,2022-08-26,33,93,5,98,83.64,0
Rocco's Island: Ring to End the Pain,2022-03-02,13,93,5,98,83.64,0
TYRONE vs COPS VR,2022-10-01,8,93,5,98,83.64,0
MicroWorks,2022-09-02,248,171,14,185,83.63,2
Time Master,2022-01-18,12,63,2,65,83.63,0
SCP Strategy,2022-05-05,28,404,45,449,83.62,1
Arcade Spirits: The New Challengers,2022-05-27,147,102,6,108,83.62,2
Knight's Try,2022-01-27,33,111,7,118,83.61,0
Room 301 NO.6,2022-09-21,28,111,7,118,83.61,0
FAREWELL SEN,2022-10-29,21,111,7,118,83.61,0
Cut to the Core,2022-08-01,6,83,4,87,83.61,0
Witchpunk,2022-11-18,39,137,10,147,83.6,0
Sigh of the Abyss: Shadow Bonds,2022-04-05,20,73,3,76,83.6,1
Ys IX -Monstrum NOX-,2022-01-19,149,210,19,229,83.59,10
Gunlocked,2022-12-06,69,286,29,315,83.58,2
Winter Falling,2022-11-08,68,153,12,165,83.56,5
Pixel Cup Soccer - Ultimate Edition,2022-10-14,332,422,48,470,83.55,17
Inside the Backrooms,2022-06-20,15033,27301,4786,32087,83.54,850
I Am Sakuya: Touhou FPS Game,2022-09-13,33,336,36,372,83.54,2
Insomnis,2022-01-07,25,185,16,201,83.53,0
Salamander County Public Television,2022-07-29,8,62,2,64,83.53,1
Mess Quest,2022-11-09,10,62,2,64,83.53,0
Manufactoria 2022,2022-08-16,34,51,1,52,83.53,0
Dead Forest,2022-07-26,8,39,0,39,83.53,0
Dead Forest,2022-07-26,8,39,0,39,83.53,0
Dead Forest,2018-08-04,3,6,28,34,28.74,0
Dead Forest,2018-08-04,3,6,28,34,28.74,0
Geballer,2022-06-10,9,39,0,39,83.53,0
SokoChess,2022-08-12,8,39,0,39,83.53,0
Songs from the Iron Sea,2022-09-22,21,39,0,39,83.53,1
Cozy Time,2022-07-13,46,144,11,155,83.52,19
Freight Hopper,2022-07-29,10,72,3,75,83.51,1
Albert Innovation,2022-10-28,9,91,5,96,83.49,0
Frontier Hunter: Erza’s Wheel of Fortune,2022-12-15,343,548,67,615,83.45,44
Born Into Fear,2022-03-21,27,151,12,163,83.45,1
Thymesia,2022-08-18,3224,4371,699,5070,83.44,52
Racingmaybe,2022-01-10,11,61,2,63,83.44,0
Airborne Kingdom,2022-03-07,1136,1381,197,1578,83.43,23
Kamikaze Veggies,2022-07-07,17,71,3,74,83.42,0
Self-Delusion,2022-08-17,20,71,3,74,83.42,0
Blood Nova,2022-10-05,8,71,3,74,83.42,1
The Scorchfarer,2022-04-15,8,50,1,51,83.42,0
Shooting Game KARI,2022-08-04,14,50,1,51,83.42,0
Arcade Paradise,2022-08-11,511,692,89,781,83.41,20
Hot Springs Story,2022-03-28,87,142,11,153,83.41,5
Night At the Gates of Hell,2022-09-15,108,436,51,487,83.4,2
Ticklish Tessa,2022-06-03,7,38,0,38,83.4,0
Winging It,2022-02-11,10,38,0,38,83.4,0
Sky Caravan,2022-05-05,8,38,0,38,83.4,0
Summum Aeterna,2022-06-16,53,166,14,180,83.39,2
Fobia - St. Dinfna Hotel,2022-06-28,310,954,130,1084,83.37,29
Eternal Threads,2022-05-19,77,272,28,300,83.37,5
Three Finger Battle Arena,2022-02-26,101,279,29,308,83.36,1
黑猫魔法师,2022-01-21,91,189,17,206,83.36,0
Hack and Slime,2022-06-01,18,107,7,114,83.35,1
Space Bandit,2022-09-18,10,60,2,62,83.34,0
Fabular: Prologue,2022-07-08,27,60,2,62,83.34,0
Queer Man Peering Into A Rock Pool.jpg,2022-07-13,10,70,3,73,83.33,0
BLACKJACK and WAIFUS,2022-02-14,49,384,44,428,83.31,2
Neodash,2022-08-17,185,370,42,412,83.31,0
Chicken Feet,2022-10-25,86,233,23,256,83.3,2
Pets at Work,2022-02-28,30,115,8,123,83.3,0
Hamster Playground,2022-08-22,546,858,116,974,83.29,49
The Whispering Valley,2022-11-30,11,79,4,83,83.28,1
温泉旅館のパイズリ怪異,2022-04-11,7,37,0,37,83.27,1
That's Not How it Happened,2022-08-08,3,37,0,37,83.27,0
Samurai Bringer,2022-04-21,1360,766,102,868,83.26,12
Dream Hacker,2022-08-30,181,347,39,386,83.26,9
Get Achievements for Achievements,2022-03-01,7,88,5,93,83.26,0
Tide Up,2022-03-11,46,163,14,177,83.24,2
The Crackpet Show,2022-12-15,136,448,54,502,83.21,5
The Bible,2022-11-14,57,352,40,392,83.21,9
Letters - a written adventure,2022-02-09,47,122,9,131,83.21,1
Onde,2022-03-17,18,122,9,131,83.21,0
DEPO : Death Epileptic Pixel Origins,2022-07-25,37,105,7,112,83.21,1
Grindstone,2022-06-20,57,105,7,112,83.21,6
Sand:box,2022-11-23,26,105,7,112,83.21,7
Planet S,2022-07-01,75,434,52,486,83.2,5
Insect Swarm,2022-06-01,392,818,111,929,83.19,94
Griddy,2022-08-22,7,78,4,82,83.19,0
MADiSON,2022-07-08,506,1615,241,1856,83.17,20
The Closing Shift | 閉店事件,2022-03-19,278,1397,205,1602,83.17,14
Pocket Academy,2022-06-13,173,113,8,121,83.17,6
Two Point Campus,2022-08-09,7553,2656,418,3074,83.16,565
Cat Cafe Manager,2022-04-14,582,1175,169,1344,83.15,27
Boo Men,2022-09-15,404,1241,180,1421,83.14,10
Car Tehc,2022-05-29,7,36,0,36,83.14,0
Heartstop,2022-05-05,6,36,0,36,83.14,0
天香与小百合 - Tinheung & Sayuri,2022-08-05,4,36,0,36,83.14,1
No More Future,2022-10-07,6,36,0,36,83.14,1
MIND CORRIDORS: Paroniria,2022-11-28,4,36,0,36,83.14,0
Diplomacy is Not an Option,2022-02-09,3180,3535,572,4107,83.13,282
Super Ride Grandpa,2022-05-09,5,58,2,60,83.13,0
Skala,2022-10-04,45,176,16,192,83.12,0
Fears to Fathom - Episode 2,2022-01-06,96,986,139,1125,83.1,10
A.R.D. Alien Removal Division,2022-06-17,149,805,110,915,83.1,1
Spell Defender,2022-10-10,42,112,8,120,83.1,0
Coloring Game: Girls,2022-07-22,76,77,4,81,83.1,5
Windjammers 2,2022-01-20,492,429,52,481,83.09,3
Cactus Simulator,2022-02-04,53,198,19,217,83.09,10
Hentai Mission Ukraine,2022-05-03,5,144,12,156,83.07,0
Class Escape,2022-03-25,15,47,1,48,83.07,0
a completely normal dating simulation that is definitely completely sweet innnocent and normal: SOMETHINGETH ANIVERSARY EDITION,2022-08-26,1041,103,7,110,83.06,0
Mushy,2022-02-16,266,1207,176,1383,83.05,5
The Last Hero of Nostalgaia,2022-10-19,356,629,83,712,83.04,37
Fresh Start Cleaning Simulator,2022-12-20,368,565,73,638,83.04,24
Superbugs: Awaken,2022-03-23,50,159,14,173,83.04,0
Cursed 2,2022-04-22,39,111,8,119,83.04,0
Counterpact,2022-10-14,34,111,8,119,83.04,1
Run N' Gun,2022-04-14,16,94,6,100,83.03,1
The Legend of Heroes: Ao no Kiseki KAI,2022-01-12,66,143,12,155,83.02,20
Everdell,2022-07-28,152,240,25,265,83.01,23
Regiments,2022-08-16,1258,1448,217,1665,83.0,63
Depths of Sanity,2022-11-02,6,35,0,35,83.0,0
BORE DOME,2022-05-30,6,35,0,35,83.0,0
Turbo Sloths,2022-12-08,5,35,0,35,83.0,0
Virtual Maid Streamer Ramie,2022-01-20,16,35,0,35,83.0,0
Sneaky Rat,2022-10-22,8,35,0,35,83.0,0
Neon Sundown,2022-03-18,185,282,31,313,82.99,16
Walk While My Grandmother Plays The Piano,2022-11-04,9,150,13,163,82.97,0
TFC: The Fertile Crescent,2022-03-29,34,110,8,118,82.97,1
Temtem,2022-09-06,39572,30775,5679,36454,82.96,735
Farthest Frontier,2022-08-09,24910,10223,1799,12022,82.96,"2,452"
Tin Can,2022-05-12,282,650,87,737,82.96,1
Ikonei Island: An Earthlock Adventure,2022-08-18,42,118,9,127,82.95,6
Kawaii Hentai Girls 2,2022-06-09,21,93,6,99,82.95,0
Hausmeister,2022-10-11,11,66,3,69,82.95,0
Kriegsfront Battlescaper,2022-08-04,11,46,1,47,82.95,0
秋恋物语 Autumn Romance,2022-02-04,12,46,1,47,82.95,0
Rimward Basilisk,2022-12-07,12,46,1,47,82.95,0
长明火计划 Project: Eternal Flame,2022-07-08,30,84,5,89,82.93,0
Grim Quest,2022-04-01,15,84,5,89,82.93,0
Unlock the Feelings,2022-05-06,12,84,5,89,82.93,0
DEATHWATCH,2022-10-21,18,84,5,89,82.93,1
Fishing Paradiso,2022-06-01,101,149,13,162,82.92,1
Springblades,2022-11-25,110,75,4,79,82.92,0
RXC - Rally Cross Challenge,2022-11-22,17,56,2,58,82.91,2
Super Ember Kaboom,2022-06-15,6,56,2,58,82.91,0
瓔珞事件簿之誰殺了愛情,2022-01-31,15,56,2,58,82.91,0
Keplerth,2022-05-24,7526,3114,509,3623,82.9,269
Army of Ruin,2022-10-27,1021,913,130,1043,82.9,73
I got a millenary cat,2022-10-07,240,341,40,381,82.9,13
Chili Con Valley,2022-01-17,10,117,9,126,82.89,0
Crash Bandicoot™ 4: It’s About Time,2022-10-18,454,1013,147,1160,82.87,247
Session: Skate Sim,2022-09-22,1757,8502,1495,9997,82.86,311
Altero,2022-10-17,5,34,0,34,82.85,0
Amberial Dreams,2022-10-18,19,34,0,34,82.85,1
Newton Going Home,2022-01-20,5,34,0,34,82.85,0
Supercow,2022-03-05,6,34,0,34,82.85,3
Lit Up,2022-05-09,6,34,0,34,82.85,0
Amber City,2022-09-01,23,34,0,34,82.85,0
Katydids,2022-06-14,11,34,0,34,82.85,0
Boom Slingers,2022-09-16,10,34,0,34,82.85,0
MopGarden's Veggie Cart,2022-11-30,7,34,0,34,82.85,0
TurnTheLine,2022-04-01,33,83,5,88,82.84,5
Ignited Steel: Prologue,2022-10-14,466,83,5,88,82.84,0
Timemelters,2022-10-12,27,65,3,68,82.84,0
Light & Shadow,2022-11-24,18,124,10,134,82.82,0
Gunborg: Dark Matters,2022-03-04,4,45,1,46,82.82,0
Lapin,2022-11-17,33,91,6,97,82.79,2
Eiyuden Chronicle: Rising,2022-05-10,1163,1249,188,1437,82.78,49
Tetris for Two,2022-01-25,30,241,26,267,82.78,5
Berserk Mode,2022-01-09,15,107,8,115,82.75,0
Superfly,2022-06-18,63,414,52,466,82.74,4
Dexter Stardust : Adventures in Outer Space,2022-03-03,19,64,3,67,82.74,0
Reefland,2022-10-17,22,64,3,67,82.74,0
ガチムチでドスケベな家庭教師のお兄さんと過ごす夏,2022-10-22,80,64,3,67,82.74,0
Darold The Doomer: Psychedelic Lucid Dreams,2022-04-06,6,73,4,77,82.73,1
Gabenwood: 99 Hidden Bucks,2022-11-07,6,73,4,77,82.73,0
Lost and Hound,2022-08-17,8,33,0,33,82.7,0
Fluffy Milo,2022-03-28,6,33,0,33,82.7,0
Infinite Turtles,2022-06-19,11,33,0,33,82.7,1
房间的秘密,2022-07-08,9,33,0,33,82.7,1
Colorful Recolor,2022-08-10,5,33,0,33,82.7,0
Cat Herder,2022-11-03,18,33,0,33,82.7,0
Know by heart...,2022-02-10,255,527,70,597,82.69,0
Secret Summer,2022-07-05,136,273,31,304,82.69,7
RoboCo,2022-11-03,98,98,7,105,82.69,4
start;again,2022-03-31,5,44,1,45,82.69,0
NOX: Chapter 1,2022-12-23,8,44,1,45,82.69,0
Lust Academy,2022-04-12,952,960,141,1101,82.68,72
Boxville,2022-09-30,24,114,9,123,82.68,1
Mokoko X,2022-04-07,32,106,8,114,82.68,0
Pool Slide Story,2022-07-04,104,106,8,114,82.68,2
Froggie,2022-11-04,7,54,2,56,82.68,0
lure,2022-04-08,11,252,28,280,82.67,0
Deluge: Threnody of Crashing Waves,2022-07-08,18,137,12,149,82.66,1
Yomawari: Lost in the Dark,2022-10-25,110,144,13,157,82.63,2
YAKIMOCHI STREAM,2022-01-22,32,105,8,113,82.61,1
Zombie Rollerz: Pinball Heroes,2022-03-02,126,236,26,262,82.59,11
與經紀人戀愛是絕對禁止！,2022-03-23,456,540,73,613,82.58,10
Ukraine War Stories,2022-10-18,86,711,101,812,82.56,2
My Dad Left Me,2022-08-05,6,53,2,55,82.56,0
Father's Day,2022-10-22,53,342,42,384,82.55,7
Solitaire Expeditions,2022-07-23,14,43,1,44,82.55,2
Weeping Falls Massacre,2022-06-16,11,43,1,44,82.55,0
Nekomew's Nightmares,2022-10-28,13,32,0,32,82.55,0
Despot's Game: Dystopian Army Builder,2022-09-29,1463,2186,358,2544,82.54,67
冥婚交友中心《厲鬼的戀愛指南》,2022-02-08,767,575,79,654,82.54,2
Solar Ash,2022-12-08,172,406,52,458,82.54,5
The Infinite Black 2,2022-10-29,53,135,12,147,82.54,29
ABRISS,2022-04-14,213,295,35,330,82.53,0
fault - StP - LIGHTKRAVTE,2022-05-28,101,295,35,330,82.53,1
Relapse,2022-10-12,44,142,13,155,82.51,1
重构,2022-03-29,403,359,45,404,82.48,3
Biters & Bullets: Prologue,2022-07-19,315,233,26,259,82.47,3
Automon,2022-03-04,89,111,9,120,82.47,1
The Backrooms: Survival,2022-03-31,78,804,118,922,82.44,4
Catie in MeowmeowLand,2022-03-31,15,70,4,74,82.44,1
It's Kooky,2022-11-01,23,52,2,54,82.44,0
Haha Doodle,2022-01-25,318,118,10,128,82.42,1
Dead Beacon,2022-11-18,10,61,3,64,82.42,0
reIterate(),2022-01-13,10,42,1,43,82.41,0
NoWayBack无路可退,2022-10-20,52,42,1,43,82.41,0
Automaton Lung,2022-12-16,6,42,1,43,82.41,0
The Archipelago,2022-11-11,971,42,1,43,82.41,0
Polda 3,2022-12-11,32,42,1,43,82.41,3
Sir Whoopass,2022-08-18,600,616,87,703,82.4,9
Brewmaster: Beer Brewing Simulator,2022-09-29,581,573,80,653,82.39,22
White Lavender,2022-06-20,15,110,9,119,82.39,0
The Forest Quartet,2022-12-08,10,78,5,83,82.39,0
Riding Seas,2022-01-31,6,31,0,31,82.39,0
Kalyzmyr,2022-03-11,4,31,0,31,82.39,0
Witchhazel Woods,2022-08-12,4,31,0,31,82.39,0
Pierre's Adventures in French,2022-10-14,6,31,0,31,82.39,1
Extraneum,2022-06-15,5,31,0,31,82.39,0
TTV4,2022-07-07,2,31,0,31,82.39,0
Blossom Tales 2: The Minotaur Prince,2022-08-16,43,86,6,92,82.37,3
FPS Chess,2022-07-16,3142,15180,2861,18041,82.36,580
FixFox,2022-03-31,27,196,21,217,82.35,5
Police Simulator: Patrol Officers,2022-11-10,3330,9899,1833,11732,82.33,446
Sackboy™: A Big Adventure,2022-10-27,610,1329,211,1540,82.32,155
Sandwalkers: The Fourteenth Caravan,2022-10-26,241,256,30,286,82.32,1
Military Conflict: Vietnam,2022-12-16,228,611,87,698,82.31,12
Fidget Spinner RPG,2022-05-02,110,124,11,135,82.31,5
CRAYON SHINCHAN The Storm Called! FLAMING KASUKABE RUNNER!!,2022-10-18,10,51,2,53,82.31,0
Medieval Fantasy Survival Simulator 2 Gladiator Edition,2022-11-07,4,51,2,53,82.31,0
Watch Your Plastic Duck,2022-09-09,17,101,8,109,82.3,1
Flowers -Le volume sur hiver-,2022-06-18,377,421,56,477,82.29,3
DREAM LOGIC,2022-09-06,19,131,12,143,82.29,1
Ruins Of Mitriom,2022-01-11,23,77,5,82,82.29,0
Lights Off!,2022-05-27,50,1246,197,1443,82.28,4
The Golden Rose: Book One,2022-06-02,207,116,10,126,82.28,6
Whateverland,2022-09-15,32,93,7,100,82.28,2
Queen Beast,2022-12-06,14,93,7,100,82.28,0
Zombies and Keys,2022-07-21,3,41,1,42,82.27,0
Dead Man's Rest,2022-03-14,9,41,1,42,82.27,1
Manafinder,2022-10-05,22,41,1,42,82.27,0
Love Death & Veggies,2022-01-07,3,41,1,42,82.27,0
My Big Sister: Remastered,2022-10-25,6,41,1,42,82.27,1
Azure Striker Gunvolt 3,2022-10-13,216,228,26,254,82.26,7
Turbo Golf Racing,2022-08-04,546,376,49,425,82.25,8
Parkour Tag,2022-01-24,61,152,15,167,82.25,5
Security Booth: Director's Cut,2022-08-19,40,123,11,134,82.25,0
Captain Bones,2022-07-27,48,173,18,191,82.24,2
Animal Shelter,2022-03-23,1750,1575,257,1832,82.22,212
Dungeon Village,2022-03-28,288,381,50,431,82.22,22
The Swordbearer,2022-07-04,69,100,8,108,82.22,2
Galaxy Tales: Story of Rapunzel,2022-06-30,4,30,0,30,82.22,0
The Cartomancy Anthology,2022-08-09,13,30,0,30,82.22,0
Astrocat: Milky Way Journey,2022-04-15,6,30,0,30,82.22,0
Dragon Mine,2022-08-17,10,30,0,30,82.22,0
Shiny Ski Resort,2022-11-28,31,30,0,30,82.22,0
Aery VR - Calm Mind,2022-12-19,4,30,0,30,82.22,0
伊格利亚战记,2022-04-13,563,1294,207,1501,82.2,63
Lost In Fantaland,2022-09-26,264,266,32,298,82.2,49
Cartridge Defense,2022-09-03,21,76,5,81,82.2,1
Tales From The Unending Void,2022-05-02,211,259,31,290,82.19,15
Of Blades & Tails,2022-10-19,43,84,6,90,82.19,1
Telepath Tactics Liberated,2022-03-14,32,84,6,90,82.19,3
Life on the Edge,2022-06-17,20,59,3,62,82.19,2
Skator Gator,2022-01-17,5,50,2,52,82.19,0
Numeral Lord,2022-10-15,24,50,2,52,82.19,2
Forgive Me Father,2022-04-07,333,2185,370,2555,82.17,74
Audio Trip,2022-12-19,15,239,28,267,82.17,1
My Gaming Club,2022-12-14,181,452,62,514,82.15,189
EarthRoyale,2022-07-29,33,99,8,107,82.14,5
City Bus Manager,2022-11-10,986,660,97,757,82.13,161
pemsa,2022-04-13,32,114,10,124,82.13,1
Rhapsody: A Musical Adventure,2022-08-30,26,67,4,71,82.12,3
The Rat Plague,2022-11-14,99,67,4,71,82.12,0
My devil's voice,2022-08-30,56,40,1,41,82.12,1
SokoWinter,2022-03-13,7,40,1,41,82.12,0
Twin Cores,2022-09-14,6,40,1,41,82.12,0
Tournament Ark,2022-12-19,36,75,5,80,82.1,2
AGRYOS: Recovering Eden,2022-02-11,12,75,5,80,82.1,0
Repetendium,2022-11-04,176,135,13,148,82.08,27
Pants Quest,2022-03-02,10,58,3,61,82.07,0
Dungeons & Dragons: Krynn Series,2022-03-29,78,58,3,61,82.07,16
What if your girl was a frog?,2022-06-03,10,190,21,211,82.06,0
Cube Racer 2,2022-03-09,92,223,26,249,82.05,10
Curtain Call,2022-04-26,7,49,2,51,82.05,0
A HERO AND A GARDEN,2022-05-05,7,49,2,51,82.05,0
SquishCraft,2022-07-27,26,49,2,51,82.05,0
Solanaceae: After All,2022-10-06,9,29,0,29,82.04,0
Tumblebugs,2022-03-18,12,29,0,29,82.04,5
Pengu Never Left,2022-02-20,3,29,0,29,82.04,0
Hare Apparent,2022-04-04,4,29,0,29,82.04,0
Egglien,2022-08-05,4,29,0,29,82.04,0
东方光耀夜 ~ Lost Branch of Legend,2022-08-18,302,368,49,417,82.03,44
Kayak VR: Mirage,2022-07-12,126,536,77,613,82.02,4
Salt 2,2022-09-20,753,606,89,695,82.01,38
Illusion,2022-03-01,24,105,9,114,82.01,0
Cafeteria Nipponica,2022-07-04,285,105,9,114,82.01,7
Isonzo,2022-09-13,4196,4922,901,5823,81.99,369
Kanjozoku Game レーサー,2022-07-17,622,2413,419,2832,81.99,13
筒楼异事,2022-10-21,62,112,10,122,81.98,0
Slot Shots Pinball Collection,2022-10-18,5,39,1,40,81.97,0
Mystwood Manor,2022-09-30,1898,690,104,794,81.96,100
The Tale of Bistun,2022-07-13,27,140,14,154,81.95,0
Seashell,2022-03-28,6,57,3,60,81.95,0
Kris and the City of Pleasure,2022-09-16,38,57,3,60,81.95,2
Hand Simulator: Rendezvous,2022-11-01,172,601,89,690,81.92,5
The Inheritance of Crimson Manor,2022-05-05,66,290,37,327,81.92,2
Toy Tanks,2022-05-12,10,48,2,50,81.92,0
UuultraC,2022-03-24,27,48,2,50,81.92,2
Grand Prix Story,2022-10-11,123,48,2,50,81.92,7
Miss Kawaii 3,2022-12-02,15,48,2,50,81.92,0
Aliens vs. Ghosts,2022-07-06,62,180,20,200,81.9,5
Dawn of the Monsters,2022-03-15,24,81,6,87,81.9,0
The Creature of Chaos,2022-03-14,6,81,6,87,81.9,0
Biomisland,2022-10-15,33,81,6,87,81.9,0
Dream Team Basketball,2022-12-12,27,81,6,87,81.9,3
Trifox,2022-10-14,17,73,5,78,81.89,0
Astral Slider,2022-03-10,20,73,5,78,81.89,0
For Mother Matron,2022-10-17,15,73,5,78,81.89,0
tERRORbane,2022-04-01,196,232,28,260,81.88,7
Ubaste,2022-09-27,12,96,8,104,81.88,0
Ghost Song,2022-11-03,685,656,99,755,81.87,5
This is a Ghost,2022-12-09,119,225,27,252,81.86,8
Beers and Boomerangs,2022-11-22,6,28,0,28,81.86,0
Kitten Burst,2022-09-02,7,28,0,28,81.86,0
Go! Go! PogoGirl,2022-01-26,7,28,0,28,81.86,0
Platypus Adventures,2022-07-07,6,28,0,28,81.86,0
Retro Kart Rush,2022-03-10,5,28,0,28,81.86,0
Triga,2022-05-19,8,28,0,28,81.86,0
TPORT,2022-07-13,4,28,0,28,81.86,0
妖与夜的幻想,2022-03-23,3,28,0,28,81.86,0
Arrival of Beasts,2022-05-13,10,28,0,28,81.86,0
Chess Pills,2022-06-16,3,28,0,28,81.86,0
Fishing Game,2022-08-25,5,28,0,28,81.86,0
Hermit Home Designer,2022-09-15,4,28,0,28,81.86,2
Signal & Echo: Iris is Missing (demo),2022-11-02,5,28,0,28,81.86,0
Idle Research,2022-08-01,4787,881,139,1020,81.85,210
Brigandine The Legend of Runersia,2022-05-11,1547,654,99,753,81.84,47
Portal Dungeon,2022-12-15,1332,445,63,508,81.84,259
猎魔战纪,2022-05-25,116,145,15,160,81.83,9
猎魔战纪,2022-05-25,116,145,15,160,81.83,0
猎魔战纪,2020-03-21,6,3,4,7,46.68,9
猎魔战纪,2020-03-21,6,3,4,7,46.68,0
Defending Lydia Collier,2022-12-14,38,38,1,39,81.81,4
Eremidia - Archivist's Curse,2022-08-15,16,38,1,39,81.81,0
Spellbook Demonslayers,2022-11-02,944,754,117,871,81.8,27
佩尔霍宁,2022-06-08,17,158,17,175,81.79,0
Escape Academy,2022-07-14,305,466,67,533,81.78,25
白晓,2022-05-03,9,64,4,68,81.78,0
The Rabbit's Scroll,2022-06-25,14,64,4,68,81.78,0
Molytropia: Cloud in Shape of Hurt,2022-12-07,4,64,4,68,81.78,0
Gore Screaming Show,2022-11-12,27,47,2,49,81.78,1
Golf Gang,2022-05-19,684,858,136,994,81.77,34
三国群英志,2022-12-02,34,109,10,119,81.75,7
灵墟,2022-07-08,400,498,73,571,81.71,61
Dark Siren,2022-12-17,17,150,16,166,81.71,4
Block'Em!,2022-09-08,152,79,6,85,81.71,0
东方梦无境 ～ Dreamland of Infinity,2022-11-15,99,79,6,85,81.71,1
Fight of Steel: Infinity Warrior,2022-07-15,46,55,3,58,81.69,2
HoverRace,2022-02-07,13,55,3,58,81.69,0
Five nights at Floppa 0,2022-07-01,4,55,3,58,81.69,0
Makai Kingdom: Reclaimed and Rebound,2022-05-10,135,86,7,93,81.66,8
リトルハーツ,2022-12-02,48,27,0,27,81.66,1
SOKOBOT,2022-03-04,11,27,0,27,81.66,0
Bomb Club Deluxe,2022-03-01,14,27,0,27,81.66,0
SEARCH ALL - CRABS,2022-02-17,3,27,0,27,81.66,0
I Hate You Please Suffer - Basic,2022-04-27,4,27,0,27,81.66,0
Downpurr,2022-06-13,8,27,0,27,81.66,1
PUTRID SHOT ULTRA,2022-11-07,8,27,0,27,81.66,0
Aery - Path of Corruption,2022-12-16,6,27,0,27,81.66,0
Deadly Harvest,2022-10-24,14,27,0,27,81.66,0
ASTRONAUTILUS,2022-03-30,15,37,1,38,81.65,1
TitTok 2,2022-03-07,5,37,1,38,81.65,0
Corn Defenders,2022-04-13,4,37,1,38,81.65,0
I commissioned some bees 2,2022-06-23,10,37,1,38,81.65,2
安科俱乐部,2022-01-15,27,46,2,48,81.63,0
HEROish,2022-12-16,8,46,2,48,81.63,0
SEARCH ALL - SPIDERS,2022-03-01,3,46,2,48,81.63,0
Pixel Samurai,2022-06-16,12,78,6,84,81.61,0
Jitsu Squad,2022-03-29,61,168,19,187,81.6,0
RATUZ,2022-04-22,72,200,24,224,81.59,0
Zapling Bygone,2022-08-05,36,107,10,117,81.59,0
Chambers of Devious Design,2022-09-05,47,70,5,75,81.57,2
Scarlet Tower,2022-10-31,233,727,115,842,81.56,94
Runes of Pandemonium,2022-02-22,14,54,3,57,81.56,2
PongPong Girl,2022-08-17,13,54,3,57,81.56,0
Forward: Escape the Fold - Ultimate Edition,2022-03-29,396,468,69,537,81.55,4
My life as an archeologist,2022-01-10,642,255,33,288,81.54,3
The Backroom - Lost and Found,2022-07-25,24,186,22,208,81.53,5
Dealer's Life 2,2022-02-15,2884,2595,472,3067,81.52,216
Aim Climb,2022-03-19,90,173,20,193,81.52,0
Romancing SaGa -Minstrel Song- Remastered,2022-12-01,2410,160,18,178,81.52,42
NinNinDays2,2022-01-20,65,106,10,116,81.51,0
Smutty Scrolls,2022-09-19,99,77,6,83,81.5,0
An Outcry,2022-01-05,9,77,6,83,81.5,0
Astro Colony,2022-11-07,2751,1009,168,1177,81.48,98
Nyaaaanvy,2022-04-22,55,45,2,47,81.48,2
Mini Gardens - Logic Puzzle,2022-03-22,9,45,2,47,81.48,0
Madcap Mosaic,2022-08-15,25,45,2,47,81.48,0
The Most Awesome Game Ever Made,2022-11-15,6,45,2,47,81.48,0
Hentai BunnyGirl,2022-11-22,5,45,2,47,81.48,0
The Maze,2022-12-08,6,36,1,37,81.47,0
The Maze,2022-12-08,6,36,1,37,81.47,0
The Maze,2022-12-08,6,36,1,37,81.47,0
The Maze,2022-06-07,2,1,0,1,59.42,0
The Maze,2022-06-07,2,1,0,1,59.42,0
The Maze,2022-06-07,2,1,0,1,59.42,0
The Maze,2020-06-13,2,1,1,2,50.0,0
The Maze,2020-06-13,2,1,1,2,50.0,0
The Maze,2020-06-13,2,1,1,2,50.0,0
Garden Guardian,2022-08-10,14,36,1,37,81.47,0
Bullet Hell Monday,2022-09-12,14,36,1,37,81.47,0
Every Day's Different,2022-02-12,9,26,0,26,81.46,0
Falling Out,2022-10-05,14,26,0,26,81.46,0
Very Very Valet,2022-05-26,15,26,0,26,81.46,0
Astronium,2022-02-06,6,26,0,26,81.46,0
Skeleton Scramble Deluxe,2022-03-18,9,26,0,26,81.46,0
Captain Cigarrr,2022-03-04,5,26,0,26,81.46,0
Jigsaw Bestiary,2022-02-21,6,26,0,26,81.46,1
Cupid Kiss,2022-07-22,4,26,0,26,81.46,0
Kid Ball Adventure,2022-09-01,8,26,0,26,81.46,0
Space Turbo 2,2022-05-24,4,26,0,26,81.46,0
Astrocat: Skylar´s Memories,2022-06-17,5,26,0,26,81.46,0
Lost Lands: Sand Captivity,2022-12-09,38,26,0,26,81.46,4
Fabric Of Reality,2022-12-15,8,26,0,26,81.46,0
Check it Out!,2022-04-29,70,389,56,445,81.45,11
My Dream is a Lost Memory,2022-06-19,3,119,12,131,81.45,0
Suhoshin,2022-04-14,29,91,8,99,81.44,0
The Genesis Project,2022-04-13,615,806,131,937,81.43,17
SEX with HITLER 2,2022-12-17,690,165,19,184,81.43,3
Miss Kawaii,2022-09-19,20,98,9,107,81.43,0
完美的一天 / A Perfect Day,2022-02-25,1732,1248,214,1462,81.42,9
Everglow,2022-07-24,11,61,4,65,81.42,0
沃姆斯传说：午夜新娘,2022-08-11,7,61,4,65,81.42,0
Wolves on the Westwind,2022-05-25,38,53,3,56,81.42,2
Lost2,2022-09-30,691,975,163,1138,81.39,25
Orbital Bullet,2022-03-21,131,398,58,456,81.38,5
King Arthur: Knight's Tale,2022-04-26,5376,4005,761,4766,81.37,320
Angry Putin,2022-05-08,6,138,15,153,81.37,0
The Backrooms: Lost Tape,2022-12-24,79,385,56,441,81.34,4
My First Femboy Date,2022-08-25,6,97,9,106,81.34,0
Don't Shit On My #!$@& Roof,2022-09-27,94,97,9,106,81.34,2
h8machine,2022-08-04,10,44,2,46,81.33,0
Heat Death,2022-07-18,32,44,2,46,81.33,0
MAGICAL DEATHPAIR,2022-01-11,7,44,2,46,81.33,0
Hunt for Junk,2022-06-23,10,44,2,46,81.33,0
骸心 Mainbody,2022-11-06,5,44,2,46,81.33,0
Is Simon There?,2022-05-06,16,188,23,211,81.3,1
Wayward Strand,2022-09-15,16,60,4,64,81.3,0
Outshine,2022-11-03,10,35,1,36,81.3,0
Mega Knockdown,2022-07-29,7,35,1,36,81.3,0
Starless,2022-08-25,7,35,1,36,81.3,0
SiNKR 3,2022-08-25,7,35,1,36,81.3,0
Shadow of the Guild,2022-11-10,7,35,1,36,81.3,0
Axolotl is Dry,2022-04-25,9,35,1,36,81.3,0
Kraino Origins,2022-09-03,6,35,1,36,81.3,0
The Robot Girl Meets The Human!,2022-08-19,5,35,1,36,81.3,0
Soda Story - Brewing Tycoon,2022-07-21,109,52,3,55,81.29,1
MORODASHI SUMO,2022-08-05,102,52,3,55,81.29,1
地牢100,2022-11-25,2197,1040,177,1217,81.28,22
CashGrab,2022-09-19,15,89,8,97,81.25,0
Kevin's Path to Wizdom,2022-12-08,5,25,0,25,81.25,0
Barold,2022-10-06,8,25,0,25,81.25,0
S-IN,2022-04-14,4,25,0,25,81.25,0
The Indigo Parallel,2022-11-24,7,25,0,25,81.25,0
Nachkriegsratten Punk-Rock Puzzle,2022-06-01,3,25,0,25,81.25,0
Candle Prick,2022-11-04,5,25,0,25,81.25,0
Hot“Sento Girls”and love,2022-09-01,7,25,0,25,81.25,0
Vactics,2022-06-22,4,25,0,25,81.25,0
One Many Nobody,2022-10-11,5,25,0,25,81.25,0
Board,2022-06-17,3,25,0,25,81.25,0
Hermea,2022-08-01,5,25,0,25,81.25,0
Interrogation Simulator,2022-10-31,4,25,0,25,81.25,0
럭키 스태미나,2022-08-27,6,25,0,25,81.25,1
Rocket Bot Royale,2022-04-20,394,527,82,609,81.24,11
HITMAN 3,2022-01-20,9043,10555,2137,12692,81.23,"2,508"
Sexy Mystic Survivors,2022-11-18,1551,872,146,1018,81.23,104
藏梦,2022-08-22,11,67,5,72,81.22,0
Pill Baby,2022-03-25,10,67,5,72,81.22,0
Hello Lady! - Complete Edition,2022-01-21,181,229,30,259,81.21,2
To Be A King - Volume 1,2022-09-30,134,109,11,120,81.19,15
Latex Dungeon,2022-03-15,490,541,85,626,81.18,12
连海CASINO,2022-09-30,30,74,6,80,81.18,0
Touhou: Fading Illusion,2022-12-05,14,74,6,80,81.18,1
Space Tail: Every Journey Leads Home,2022-11-03,52,59,4,63,81.17,0
Blast Beat,2022-01-13,7,43,2,45,81.17,0
Tomboy Adventure,2022-08-30,10,43,2,45,81.17,2
Oh! Edo Towns,2022-09-05,40,43,2,45,81.17,2
Democracy 4,2022-01-13,699,3657,703,4360,81.16,98
STRIDE,2022-06-10,142,1737,315,2052,81.16,1
The Tenants,2022-10-20,4583,4715,922,5637,81.15,238
Akai Katana Shin,2022-12-14,40,51,3,54,81.14,1
净化之径,2022-10-11,9,51,3,54,81.14,0
Forgotten Realms: The Archives - Collection One,2022-03-29,138,108,11,119,81.11,31
Moo Lander,2022-05-27,8,34,1,35,81.11,0
Super Mega Zero,2022-04-20,5,34,1,35,81.11,0
Lords of Ravage - Сhapter 1,2022-09-08,22,34,1,35,81.11,0
StickmanThug3D,2022-10-09,4,34,1,35,81.11,0
Maid for Loving You,2022-12-31,21,34,1,35,81.11,0
Q.U.B.E. 10th Anniversary,2022-09-14,29,66,5,71,81.1,2
Adorable Witch 3,2022-05-07,153,410,62,472,81.09,2
a pet shop after dark,2022-08-30,87,250,34,284,81.09,0
Venture Towns,2022-05-23,84,101,10,111,81.09,12
H-Isekai Loves,2022-02-11,897,1022,177,1199,81.07,3
Intruder In Antiquonia,2022-07-08,19,73,6,79,81.07,1
Sonority,2022-05-25,27,87,8,95,81.06,0
RUMBLE,2022-09-23,227,1175,207,1382,81.05,29
Motocross: Chasing the Dream,2022-08-30,29,80,7,87,81.05,0
College Craze,2022-08-03,24,80,7,87,81.05,3
Memory Traces: japan,2022-08-10,18,58,4,62,81.04,0
Miss Kawaii 2,2022-10-26,22,58,4,62,81.04,0
All Ashes and Illusions,2022-08-03,5,24,0,24,81.03,0
amazin' George 2,2022-01-24,2,24,0,24,81.03,0
Runner Party,2022-12-22,12,24,0,24,81.03,0
ASCIILL,2022-02-25,5,24,0,24,81.03,0
NinjaThea,2022-08-23,6,24,0,24,81.03,1
Hidden Shapes - Trick or Cats,2022-10-20,4,24,0,24,81.03,0
Pocket Witch,2022-10-27,4,24,0,24,81.03,0
Of Moons and Mania,2022-12-16,3,24,0,24,81.03,0
Ghostwire: Tokyo,2022-03-24,14086,10231,2102,12333,81.02,898
Project Lazarus,2022-06-23,752,893,153,1046,81.01,38
Tentacular,2022-03-24,20,50,3,53,81.0,0
Boys Tale,2022-02-11,9,50,3,53,81.0,0
Shores of Loci,2022-05-24,5,50,3,53,81.0,0
The Ditty of Carmeana,2022-04-16,10,42,2,44,81.0,0
Entangled,2022-07-07,9,42,2,44,81.0,0
Entangled,2022-07-07,9,42,2,44,81.0,0
Entangled,2022-07-07,9,42,2,44,81.0,0
Entangled,2021-09-03,3,18,0,18,79.39,0
Entangled,2021-09-03,3,18,0,18,79.39,0
Entangled,2021-09-03,3,18,0,18,79.39,0
Entangled,2018-09-12,3,5,0,5,70.84,0
Entangled,2018-09-12,3,5,0,5,70.84,0
Entangled,2018-09-12,3,5,0,5,70.84,0
Starcom: Unknown Space,2022-12-14,419,224,30,254,80.99,7
1428: Shadows over Silesia,2022-10-04,62,113,12,125,80.98,7
Dr. Chatelet: Faith 神医,2022-11-30,36,65,5,70,80.98,0
Remnant Records,2022-07-19,133,253,35,288,80.97,12
IT Simulator,2022-06-01,12,86,8,94,80.96,2
The Backrooms 1998 - Found Footage Backroom Survival Horror Game,2022-05-25,60,529,85,614,80.92,1
PogoChamp,2022-05-26,8,33,1,34,80.92,0
Togges,2022-12-07,8,33,1,34,80.92,1
Tear Factory,2022-10-03,2,33,1,34,80.92,0
Hole in the Clouds,2022-08-26,6,33,1,34,80.92,0
Pentagons Go WEEE,2022-03-31,6,33,1,34,80.92,0
Thrill Penguin,2022-06-29,6,33,1,34,80.92,0
Reimus Awesome Holiday,2022-10-06,6,33,1,34,80.92,0
Bughouse,2022-07-14,9,112,12,124,80.9,0
Pirates: Golden tits chapter 1,2022-09-29,29,57,4,61,80.9,6
Dwarven Realms,2022-12-16,157,222,30,252,80.89,13
Persona 4 Arena Ultimax,2022-03-17,7099,2281,434,2715,80.87,70
Coffee Shop Tycoon,2022-12-19,113,456,72,528,80.86,8
HunterX,2022-04-29,141,352,53,405,80.86,9
Project R4T,2022-12-16,12,105,11,116,80.86,0
Hands of Necromancy,2022-06-20,12,85,8,93,80.85,2
Air Traffic: Greenlight,2022-02-04,18,64,5,69,80.85,5
Mister Furry,2022-12-16,36,318,47,365,80.84,5
剑与桃花,2022-07-22,7,49,3,52,80.84,0
Asian Truck Simulator,2022-09-09,7,49,3,52,80.84,0
Blood Wizard Odyssey,2022-12-12,9,49,3,52,80.84,0
クレヨンしんちゃん「オラと博士の夏休み」～おわらない七日間の旅～,2022-08-31,139,155,19,174,80.83,0
girl agent,2022-03-29,7,41,2,43,80.83,0
Super Lone Survivor,2022-10-31,15,41,2,43,80.83,0
Exodemic,2022-07-08,28,41,2,43,80.83,0
Wolfenstein: Enemy Territory,2022-04-26,577,1244,225,1469,80.82,44
Garden Simulator,2022-09-08,269,167,21,188,80.82,10
Witchy Life Story,2022-09-30,270,311,46,357,80.79,14
Armored Lab Force VULVEHICLES,2022-08-25,10,23,0,23,80.79,1
AV-Racer,2022-05-20,3,23,0,23,80.79,0
Sokolor,2022-06-17,4,23,0,23,80.79,0
Pitstop in Purgatory,2022-10-14,4,23,0,23,80.79,0
Super Choppy Orc,2022-11-16,12,23,0,23,80.79,1
SIC-1,2022-12-02,10,23,0,23,80.79,1
Freedom Drive,2022-10-28,3,23,0,23,80.79,0
Sapiens,2022-07-26,1826,1180,213,1393,80.78,78
FPS Game: Dev Test,2022-02-26,353,917,161,1078,80.78,18
PAC-MAN MUSEUM+,2022-05-26,93,231,32,263,80.77,5
Between Two Worlds,2022-08-12,135,148,18,166,80.77,11
Buggos,2022-03-17,257,425,67,492,80.76,54
Ghostlore,2022-04-14,108,172,22,194,80.76,10
I See Red,2022-10-24,13,56,4,60,80.76,0
Grocket,2022-09-09,103,56,4,60,80.76,0
Movie Quest,2022-12-17,29,56,4,60,80.76,0
Rule No. 2,2022-08-26,6,56,4,60,80.76,0
SCP: Labrat,2022-12-25,567,1936,367,2303,80.75,80
Wavetale,2022-12-12,57,123,14,137,80.75,1
F-Rank hero story,2022-01-05,4,63,5,68,80.73,0
Richman: Classic,2022-07-28,95,63,5,68,80.73,1
EON Fighter,2022-11-22,28,63,5,68,80.73,3
HeatStroke,2022-12-16,17,70,6,76,80.72,0
Midnight Legends,2022-01-06,9,32,1,33,80.72,0
Big Earth,2022-06-23,4,32,1,33,80.72,0
subROV,2022-12-02,7,32,1,33,80.72,0
Trapper: Drug Dealing RPG,2022-04-28,10,32,1,33,80.72,0
Vespa's Test,2022-08-03,6,32,1,33,80.72,0
Mushroom Card RPG,2022-10-04,25,32,1,33,80.72,2
E.E.R.I.E2,2022-11-05,34,224,31,255,80.71,4
Ballex²: The Hanging Gardens,2022-07-15,27,48,3,51,80.69,0
The Immaculate Drag,2022-01-17,3,48,3,51,80.69,0
Deflector: Specimen One,2022-03-31,28,48,3,51,80.69,0
Revita,2022-04-21,2112,1364,252,1616,80.68,104
Pocket League Story,2022-08-08,243,90,9,99,80.68,5
Warriors of the Nile 2,2022-08-24,2199,684,117,801,80.67,74
Panic Porcupine,2022-10-27,7,40,2,42,80.66,0
烛光迷局 Candlelight,2022-05-13,10,40,2,42,80.66,0
Phobies,2022-03-08,197,537,89,626,80.64,57
Tame It!,2022-03-18,284,367,57,424,80.64,5
Anglerfish,2022-11-10,24,152,19,171,80.63,4
Coin Flipper,2022-10-03,256,96,10,106,80.63,25
This Means Warp,2022-03-17,253,239,34,273,80.62,10
A Memoir Blue,2022-03-24,22,222,31,253,80.62,0
Witch Schools: Love Potions,2022-09-19,9,55,4,59,80.62,0
Boba Simulator,2022-12-01,31,69,6,75,80.6,10
Bound By Blades,2022-11-15,25,62,5,67,80.59,0
Grisaia Phantom Trigger Vol.8,2022-02-25,121,62,5,67,80.59,1
Emi - New Beginning,2022-11-08,22,62,5,67,80.59,1
米可可大冒險,2022-11-08,111,127,15,142,80.58,3
Vestige,2022-01-22,38,89,9,98,80.58,0
Mad Streets,2022-03-15,59,157,20,177,80.57,2
Touhou Ibunseki - Ayaria Dawn: ReCreation,2022-04-01,486,1231,228,1459,80.54,2
PlayForm: Human Dynamics,2022-07-27,23,82,8,90,80.54,2
IZBOT 2,2022-03-10,4,22,0,22,80.54,0
Project Absentia,2022-07-29,6,22,0,22,80.54,0
Unknown Number: A First Person Talker,2022-09-21,6,22,0,22,80.54,0
Super Nano Blaster,2022-05-03,5,22,0,22,80.54,0
Invisible Places - Pixel Art Jigsaw Puzzle,2022-01-24,2,22,0,22,80.54,0
Riley & Rochelle,2022-10-18,6,22,0,22,80.54,0
Rotund Zero,2022-04-21,4,22,0,22,80.54,0
Tales of Autumn,2022-04-30,4,22,0,22,80.54,0
Duks,2022-07-02,5,22,0,22,80.54,0
Invercity,2022-11-09,24,22,0,22,80.54,0
幻覚,2022-07-30,33,22,0,22,80.54,0
EXECUTE DADDY,2022-11-30,4,22,0,22,80.54,0
ALIEN XENOBLASTER,2022-08-23,6,22,0,22,80.54,0
Stereo Boy,2022-08-09,5,22,0,22,80.54,0
Temple of Horror,2022-10-26,6,22,0,22,80.54,0
Seaberry Keep,2022-11-11,2,22,0,22,80.54,0
Saint Kotar: The Crawling Man,2022-12-02,3,22,0,22,80.54,0
Seaberry Holiday,2022-12-07,4,22,0,22,80.54,0
Catizens,2022-08-17,93,180,24,204,80.53,4
Zorbus,2022-09-14,68,114,13,127,80.53,3
Mosaic Chronicles,2022-09-29,11,47,3,50,80.53,0
Frail Hearts: Versicorae Domlion,2022-08-16,15,47,3,50,80.53,1
Operation STEEL,2022-01-27,10,47,3,50,80.53,0
Mind Diver,2022-06-22,7,47,3,50,80.53,0
Scurvy Dogs,2022-11-01,24,47,3,50,80.53,0
Bunny Girl Story,2022-04-22,11,120,14,134,80.52,0
SKULL CHAINZ,2022-10-31,10,31,1,32,80.51,1
I Am a Rock,2022-02-18,3,31,1,32,80.51,0
PAIN,2022-06-17,9,31,1,32,80.51,0
η κλοπή του ΚΡΑΣΙΟΥ,2022-01-21,3,31,1,32,80.51,0
Rally: Endless Conquest,2022-08-19,38,31,1,32,80.51,0
Traumada,2022-08-12,4,31,1,32,80.51,0
学園スイーツ発見 ～双目（ざらめ）のドーナツ編～,2022-05-10,4,31,1,32,80.51,0
Adventures of Quin85,2022-07-29,72,31,1,32,80.51,0
Valkyrie of Phantasm,2022-10-22,277,373,59,432,80.5,0
The Shadow Government Simulator: Prologue,2022-09-07,109,138,17,155,80.5,0
B.I.O.T.A.,2022-04-12,51,132,16,148,80.5,0
Kamifuda,2022-09-13,23,75,7,82,80.5,1
尘埃见闻录,2022-01-11,21,88,9,97,80.48,0
Commando Hero,2022-12-16,20,39,2,41,80.48,0
Elven Assassin,2022-09-14,426,519,87,606,80.47,119
Overhaul,2022-10-14,22,68,6,74,80.47,0
Desktop Jumpscares,2022-07-31,11,68,6,74,80.47,0
Land of Screens,2022-02-04,6,54,4,58,80.47,0
Noun Town,2022-12-15,17,61,5,66,80.46,0
Morendo,2022-11-21,6,119,14,133,80.44,0
Foxhole,2022-09-28,11791,24649,5462,30111,80.43,"2,330"
Catch Me If You Can,2022-10-28,46,81,8,89,80.43,14
The Kids We Were,2022-01-13,43,81,8,89,80.43,0
MILF HUNTER,2022-04-01,11,81,8,89,80.43,0
Gloomgrave,2022-07-11,33,100,11,111,80.4,0
枝江第一舞斗会,2022-07-25,65,189,26,215,80.39,0
Hellfire Tactics,2022-11-10,121,142,18,160,80.36,0
Kolhii ChampionsAU,2022-08-25,37,46,3,49,80.36,0
Eira,2022-08-04,24,46,3,49,80.36,0
Yars: Recharged,2022-08-23,11,46,3,49,80.36,1
人类动物园 Human Zoo,2022-10-27,9,46,3,49,80.36,0
Chivalry 2,2022-06-12,16959,19926,4416,24342,80.34,"1,811"
花园魔三国 蜀汉篇 -The Sacrificial Girl of the Fantasy 3 Kingdoms- SHU,2022-02-25,144,171,23,194,80.34,1
Like No Other: The Legend Of The Twin Books,2022-08-25,8,60,5,65,80.32,0
Photogenic Minds : Identity,2022-09-29,53,60,5,65,80.32,9
Renai Royale,2022-09-30,133,60,5,65,80.32,2
Stillwater,2022-09-07,5,53,4,57,80.32,0
BBQ Simulator: The Squad,2022-05-25,152,669,118,787,80.31,8
Autonauts vs Piratebots,2022-07-28,763,276,42,318,80.31,25
RC Rush,2022-01-28,6,30,1,31,80.3,0
Path of Ra,2022-12-05,12,30,1,31,80.3,1
False Skies,2022-11-30,11,30,1,31,80.3,2
Scoop Kick!,2022-02-11,6,30,1,31,80.3,0
Sokobalien,2022-08-01,9,30,1,31,80.3,0
World Cruise Story,2022-10-31,32,30,1,31,80.3,1
東方蒼神縁起V -The genius of sappheiros-,2022-10-31,45,30,1,31,80.3,12
hololive ERROR,2022-09-16,171,324,51,375,80.29,4
寂夜微光 - A Flicker of Light,2022-03-09,10,105,12,117,80.29,0
Palallel,2022-05-27,16,38,2,40,80.29,2
Tough Law,2022-01-20,5,38,2,40,80.29,0
Shadow Heroes,2022-10-11,11,38,2,40,80.29,0
Die Känguru-Verschwörung,2022-12-25,11,38,2,40,80.29,0
The Elder Scrolls: Arena,2022-04-26,299,1124,211,1335,80.28,26
Wanderer,2022-01-27,141,587,102,689,80.28,9
Wanderer,2022-01-27,141,587,102,689,80.28,0
Wanderer,2022-06-28,4,18,7,25,63.75,9
Wanderer,2022-06-28,4,18,7,25,63.75,0
Robotry!,2022-10-26,5,21,0,21,80.28,0
Lost Sunday Comics,2022-03-04,2,21,0,21,80.28,0
MerFight,2022-03-31,16,21,0,21,80.28,2
Wonderputt Forever,2022-12-02,6,21,0,21,80.28,0
Chefy-Chef,2022-05-06,4,21,0,21,80.28,0
IKUSAAAAAAAN!,2022-02-26,6,21,0,21,80.28,0
The Battle Never Ends,2022-03-04,2,21,0,21,80.28,0
Dogs Cyberpuzzle,2022-06-17,3,21,0,21,80.28,0
I commissioned some bees 4,2022-07-28,6,21,0,21,80.28,0
Tux and Fanny,2022-09-08,4,21,0,21,80.28,0
 Elf World Adventure: Part 1,2022-03-15,70,264,40,304,80.26,1
Ghost Trap,2022-07-26,39,73,7,80,80.26,0
Nordic Ashes,2022-12-15,2978,1368,263,1631,80.22,854
Kawaii Hentai Girls 3,2022-08-19,17,66,6,72,80.21,0
Cyrah's Ascent,2022-06-04,31,180,25,205,80.2,0
Paint Warfare,2022-03-06,54,598,105,703,80.19,25
Cyanotype Daydream -The Girl Who Dreamed the World-,2022-02-09,206,321,51,372,80.19,8
Into the Nightmare,2022-12-03,330,110,13,123,80.19,7
Little Inner Monsters,2022-06-20,13,45,3,48,80.19,0
The Princess of the Tower Wants a Hero,2022-12-06,8,45,3,48,80.19,0
Project Beril / 贝丽尔养成计划,2022-10-28,28,59,5,64,80.18,0
On the Wings - Birth of a Hero,2022-09-08,3,59,5,64,80.18,0
The Eternal Cylinder,2022-10-13,277,310,49,359,80.17,20
Kovox Pitch,2022-01-17,16,52,4,56,80.17,0
兽设格斗前传：上,2022-03-31,7,52,4,56,80.17,0
Convenient,2022-09-23,12,52,4,56,80.17,0
Summoners War: Chronicles,2022-11-10,38641,5927,1266,7193,80.16,"25,306"
IMMORTALITY,2022-08-30,399,833,153,986,80.16,15
The Gunk,2022-04-29,165,414,69,483,80.16,3
Madshot,2022-06-09,68,103,12,115,80.11,0
Isekai Succubus ~My Genderbent Saga in Another World~,2022-01-15,77,109,13,122,80.1,4
Cardfight!! Vanguard Dear Days,2022-11-16,1587,593,105,698,80.09,103
Totemlands,2022-05-02,6,37,2,39,80.09,0
Valor,2022-11-03,6,37,2,39,80.09,0
Valor,2022-11-03,6,37,2,39,80.09,0
Valor,2021-08-03,6,12,8,20,56.0,0
Valor,2021-08-03,6,12,8,20,56.0,0
Raspberry Cube,2022-11-04,19,37,2,39,80.09,2
Pinku Kult Hex Mortis,2022-05-31,9,29,1,30,80.07,0
Chroma Chronicles,2022-06-08,17,29,1,30,80.07,0
Video Game Fables,2022-07-15,8,29,1,30,80.07,1
Roxy Raccoon's Pinball Panic,2022-03-15,4,29,1,30,80.07,1
I commissioned some bees 3,2022-07-12,8,29,1,30,80.07,2
The Resurrection Of Amelia : Across two worlds,2022-09-30,8,29,1,30,80.07,0
King Of Water,2022-11-05,5,29,1,30,80.07,0
SokoFrog,2022-12-15,6,29,1,30,80.07,0
Flower girl 2,2022-07-21,393,1557,307,1864,80.06,3
BLACKTAIL,2022-12-15,516,684,124,808,80.04,33
Krai. Digital-poetry vol. 1,2022-01-17,17,126,16,142,80.04,0
Stranded Nightmare,2022-10-19,9,58,5,63,80.04,0
Half-Earth Socialism,2022-07-19,168,450,77,527,80.03,1
Battle Bands,2022-03-17,108,120,15,135,80.03,0
Hot Spring Hero,2022-04-09,201,114,14,128,80.02,4
Archmage Ricka,2022-11-04,60,96,11,107,80.02,1
Illuminaria,2022-08-04,13,44,3,47,80.02,2
Eschaton,2022-11-03,4,44,3,47,80.02,0
Pocket Clothier,2022-07-25,32,44,3,47,80.02,1
Miss Kobayashi's Dragon Maid,2022-10-26,15,44,3,47,80.02,0
Bengan Yes,2022-12-28,108,44,3,47,80.02,0
少女的求生之路,2022-07-26,16,102,12,114,80.01,3
黎明为歌 - Melody before the Dawn,2022-03-12,13,51,4,55,80.01,0
The Mensional,2022-04-21,64,51,4,55,80.01,0
Void Prison,2022-05-19,8,51,4,55,80.01,0
Terra Invicta,2022-09-26,9826,3405,714,4119,80.0,539
Journey to the West,2022-03-10,819,692,126,818,80.0,60
Nevergrind Online,2022-06-09,1184,474,82,556,80.0,22
Cheese Runner,2022-07-14,5,20,0,20,80.0,0
Get Your Sheep Together,2022-04-02,3,20,0,20,80.0,0
Lucky Fish Bread,2022-02-10,6,20,0,20,80.0,0
Deadland 4000,2022-10-07,11,20,0,20,80.0,0
Satan's Puzzle 2,2022-05-04,3,20,0,20,80.0,0
THE DREADFUL SPACE,2022-04-30,4,20,0,20,80.0,0
Herald of Havoc,2022-12-21,4,20,0,20,80.0,0
Updog,2022-07-19,4,20,0,20,80.0,0
Philosophical Jigsaw - The Zen Koans,2022-06-01,3,20,0,20,80.0,1
明日、初めて彼女と❤,2022-08-11,21,20,0,20,80.0,0
Moorhuhn X - Crazy Chicken X,2022-10-08,9,20,0,20,80.0,2
Cube Farmer,2022-08-26,4,20,0,20,80.0,0
Garbanzo Quest,2022-09-16,4,20,0,20,80.0,0
RunBean Galactic,2022-09-13,3,20,0,20,80.0,0
Kind Heart Defenders,2022-12-21,5,20,0,20,80.0,0
Cats and Sokoban - Mimi's Scratcher,2022-12-16,4,20,0,20,80.0,0
Tiny Tactics,2022-08-05,1468,468,81,549,79.97,21
Sunday Gold,2022-10-13,193,346,57,403,79.97,10
Asterigos: Curse of the Stars,2022-10-11,1672,1513,300,1813,79.96,136
11号小镇综合症,2022-07-10,13,64,6,70,79.95,0
Little Witch Nobeta,2022-09-29,3707,8717,1929,10646,79.93,30
互联网原住民Internet Generation,2022-10-20,1070,966,184,1150,79.93,1
Almost Home Now,2022-05-26,26,491,86,577,79.92,0
South of the Circle,2022-08-03,123,593,107,700,79.89,5
Japanese Rail Sim: Journey to Kyoto,2022-06-22,11,70,7,77,79.89,0
Super Galaxy Ball,2022-10-24,35,70,7,77,79.89,0
UnHappy Place,2022-08-27,10,57,5,62,79.89,0
武林鸡侠传,2022-12-23,59,36,2,38,79.89,0
Penny for Your Thoughts,2022-03-01,5,36,2,38,79.89,0
Colors! Platform,2022-07-22,11,36,2,38,79.89,0
Daigaku Gurashi,2022-09-01,20,36,2,38,79.89,6
Rogue Tower,2022-01-28,4318,3656,777,4433,79.88,460
Escape Memoirs: Mansion Heist,2022-06-16,60,158,22,180,79.88,9
The Passenger,2022-12-29,99,76,8,84,79.85,1
Touken Ranbu Warriors,2022-05-24,94,112,14,126,79.84,3
Orgynizer,2022-10-12,11,50,4,54,79.84,0
Archtower,2022-09-30,21,50,4,54,79.84,0
True Idle Simulator,2022-09-16,26,50,4,54,79.84,16
GOR3,2022-12-01,7,106,13,119,79.83,0
Lunar Axe,2022-07-11,17,82,9,91,79.83,0
Attack at Dawn: North Africa,2022-06-07,26,43,3,46,79.83,0
Naval Hurricane,2022-11-16,15,43,3,46,79.83,1
Map Of Materials,2022-03-11,10,43,3,46,79.83,0
TitTok 3,2022-10-10,6,43,3,46,79.83,0
SOWON,2022-10-28,10,43,3,46,79.83,0
Hentai Sexy Nurses,2022-10-15,9,43,3,46,79.83,0
For a Vast Future,2022-11-01,8,28,1,29,79.83,0
DR4X,2022-01-15,3,28,1,29,79.83,0
Bee: The Knight,2022-06-11,8,28,1,29,79.83,0
Moon Dancer,2022-01-14,8,28,1,29,79.83,0
Aery - Calm Mind 2,2022-03-29,7,28,1,29,79.83,0
SEARCH ALL - CACTUSES,2022-03-01,3,28,1,29,79.83,0
Meowtopia: Expedition,2022-05-24,7,28,1,29,79.83,0
Closer To Home,2022-10-20,4,28,1,29,79.83,0
Land of the Vikings,2022-11-08,1134,806,152,958,79.81,161
Lighthouse Keeper,2022-08-23,71,238,37,275,79.81,2
Lighthouse Keeper,2022-08-23,71,238,37,275,79.81,0
Lighthouse Keeper,2020-11-22,4,139,43,182,70.88,2
Lighthouse Keeper,2020-11-22,4,139,43,182,70.88,0
魂之起源 God Souls,2022-12-02,15,63,6,69,79.81,0
建筑吧公司,2022-04-27,187,232,36,268,79.78,0
Frogun,2022-08-02,123,258,41,299,79.77,5
GOODBYE WORLD,2022-11-16,112,450,79,529,79.76,0
Forest Camp Story,2022-11-28,112,69,7,76,79.76,2
Beach Invasion 1944,2022-12-02,196,420,73,493,79.75,13
WW2 Rebuilder: Germany Prologue,2022-07-26,360,309,51,360,79.75,1
Dodge It! 2,2022-01-28,21,145,20,165,79.75,0
Cheese Game,2022-05-30,24,172,25,197,79.72,0
A Musical Story,2022-03-04,25,139,19,158,79.72,1
Poop Clicker,2022-03-26,2011,313,52,365,79.71,4
赠予神家与谎言,2022-08-26,22,87,10,97,79.71,0
Mini Matches,2022-03-21,7,19,0,19,79.71,0
Learn Japanese RPG: Hiragana Forbidden Speech,2022-10-21,5,19,0,19,79.71,0
Bistro Days,2022-02-25,8,19,0,19,79.71,0
Portal Mortal,2022-04-01,13,19,0,19,79.71,0
Cheaphaven,2022-07-22,5,19,0,19,79.71,1
On Your Hands,2022-04-16,7,19,0,19,79.71,0
One by One,2022-08-15,11,19,0,19,79.71,0
Constellations: Puzzles in the Sky,2022-05-25,4,19,0,19,79.71,0
Garbage Pail Kids: Mad Mike and the Quest for Stale Gum,2022-10-25,11,19,0,19,79.71,0
Pillars of Light,2022-09-29,4,19,0,19,79.71,0
Dragon Caffi,2022-04-21,5,19,0,19,79.71,0
Endless Bullet Heaven,2022-05-10,4,19,0,19,79.71,0
Loop,2022-07-04,3,19,0,19,79.71,0
Loop,2022-07-04,3,19,0,19,79.71,0
Loop,2020-11-24,4,81,18,99,73.86,0
Loop,2020-11-24,4,81,18,99,73.86,0
I commissioned some bees 5,2022-08-18,8,19,0,19,79.71,0
The Asafo Journey,2022-10-14,2,19,0,19,79.71,0
The Shadow Over Route 80,2022-11-23,4,19,0,19,79.71,0
Dune: Spice Wars,2022-04-26,8397,5943,1315,7258,79.69,378
The Cabin - Summer Vacation,2022-09-21,49,49,4,53,79.68,54
One Line: Letters and Codes,2022-03-10,3,35,2,37,79.68,0
MewMew - PewPew,2022-05-21,7,35,2,37,79.68,0
Furry Sex - GameDev Story 🎮,2022-10-05,28,35,2,37,79.68,0
i love me i love me not,2022-10-22,3,35,2,37,79.68,0
Mechs V Kaijus,2022-02-17,197,367,63,430,79.66,5
Demolish & Build 3: Excavator Playground,2022-08-19,54,110,14,124,79.66,6
Not Tonight 2,2022-02-11,172,203,31,234,79.65,4
Maptroid: Worlds,2022-12-12,29,42,3,45,79.65,0
Deathsmiles I・II,2022-06-22,31,42,3,45,79.65,1
The Underground Man 2,2022-09-29,108,104,13,117,79.64,0
THE KING OF FIGHTERS XV,2022-02-17,8226,4707,1035,5742,79.61,671
Crypto Miner Tycoon Simulator,2022-04-21,62,86,10,96,79.6,9
Entity Researchers: Prologue,2022-08-19,149,74,8,82,79.6,0
Nayuta no Kiseki: KAI,2022-05-25,75,55,5,60,79.58,4
Harvest Hero Origins,2022-02-08,5,27,1,28,79.58,0
Hats Are Not Allowed,2022-04-22,3,27,1,28,79.58,0
Blacken Slash,2022-07-22,10,27,1,28,79.58,0
Shadow Fate,2022-04-05,6,27,1,28,79.58,0
Eden's Last Sunrise,2022-12-02,18,27,1,28,79.58,1
Trigger Witch,2022-05-27,13,27,1,28,79.58,0
Twin Edge,2022-06-27,8,27,1,28,79.58,0
Murder Is Game Over,2022-10-25,3,27,1,28,79.58,0
Seven Deadly Dates,2022-07-08,13,27,1,28,79.58,0
Race to Kyiv,2022-05-12,3,27,1,28,79.58,0
Escape: The Endless Dogwatch,2022-08-24,5,27,1,28,79.58,0
Morris Cave,2022-09-02,6,27,1,28,79.58,0
This is Hell,2022-11-01,28,27,1,28,79.58,0
甜點王子2,2022-05-31,236,109,14,123,79.57,12
Disaster Band,2022-12-20,150,294,49,343,79.56,17
LAY,2022-06-21,56,258,42,300,79.54,5
Heroine Anthem Zero 2,2022-02-22,197,519,95,614,79.53,4
Impasto,2022-11-03,25,131,18,149,79.53,0
Peglin,2022-04-25,3764,6253,1404,7657,79.52,381
집착의 망자 - 집으로부터의 탈출,2022-05-20,37,61,6,67,79.52,0
TRAIL OUT,2022-09-07,496,1562,322,1884,79.51,15
Beautiful Mystic Defenders,2022-01-06,208,322,55,377,79.48,6
Please Fix The Road,2022-06-10,68,163,24,187,79.48,1
Catgirls From My Sweet Dream,2022-12-07,54,85,10,95,79.48,0
World of Contraptions,2022-03-24,56,73,8,81,79.48,1
精神病大王花,2022-02-14,43,152,22,174,79.47,0
Yag,2022-03-26,14,34,2,36,79.46,0
Velocity Noodle,2022-01-21,5,34,2,36,79.46,0
残世界的鸢尾花,2022-11-14,9,34,2,36,79.46,0
A Jornada de Vanildo,2022-05-09,4,34,2,36,79.46,0
Raisond'etre,2022-04-26,8,34,2,36,79.46,0
ISOLATE,2022-03-08,5,34,2,36,79.46,0
Curley Laboratory,2022-04-19,10,34,2,36,79.46,0
My Trainer is a Futanari,2022-07-17,6,34,2,36,79.46,0
Survive Till Morning,2022-11-29,12,34,2,36,79.46,0
Pathmaster,2022-10-23,8,41,3,44,79.45,0
Prop and Seek,2022-11-19,984,3622,795,4417,79.44,126
Pacifish,2022-06-07,1916,438,79,517,79.43,33
Spirits of Baciu - Prologue,2022-11-10,19,96,12,108,79.42,0
Friendsim 2,2022-04-13,53,54,5,59,79.42,0
The Hotel,2022-11-17,9,54,5,59,79.42,0
The Hotel,2022-11-17,9,54,5,59,79.42,0
The Hotel,2022-06-17,8,63,11,74,75.56,0
The Hotel,2022-06-17,8,63,11,74,75.56,0
Lost Marbles,2022-11-18,5,18,0,18,79.39,0
Lost Marbles,2022-11-18,5,18,0,18,79.39,0
Lost Marbles,2014-05-30,311,36,12,48,67.25,0
Lost Marbles,2014-05-30,311,36,12,48,67.25,0
Elevenses: The Flask,2022-11-28,4,18,0,18,79.39,0
Corpse Box Racers,2022-12-20,5,18,0,18,79.39,0
Moondrop,2022-08-12,7,18,0,18,79.39,1
Spaceship for Newbies,2022-05-13,4,18,0,18,79.39,0
Cat Powered UFO,2022-05-04,4,18,0,18,79.39,0
Cassiodora,2022-12-15,6,18,0,18,79.39,0
Teamkill,2022-02-17,12,18,0,18,79.39,0
The Sink Gods,2022-02-11,3,18,0,18,79.39,0
Zoo Seeker,2022-01-27,6,18,0,18,79.39,0
Ancient Islands,2022-10-26,6,18,0,18,79.39,0
Synchronizacja,2022-01-21,5,18,0,18,79.39,0
Gelatine,2022-09-30,3,18,0,18,79.39,0
Di-Da-Dobble,2022-02-16,4,18,0,18,79.39,0
Pretty Girls Speed,2022-02-25,3,18,0,18,79.39,0
MeteoHeroes,2022-02-28,12,18,0,18,79.39,0
Boom Bears on Stream,2022-02-11,7,18,0,18,79.39,1
Golden Rails: Road To Klondike,2022-02-24,25,18,0,18,79.39,3
Barry of Wrath,2022-03-04,5,18,0,18,79.39,0
Chico and the Magic Orchards,2022-08-08,4,18,0,18,79.39,0
Terra Flame,2022-11-17,8,18,0,18,79.39,0
Melon Dusk,2022-04-15,2,18,0,18,79.39,0
Pogo Stick Miooooooon,2022-04-15,8,18,0,18,79.39,0
The Last Tater,2022-05-19,12,18,0,18,79.39,0
Jishogi,2022-06-23,3,18,0,18,79.39,0
Death's Playground,2022-10-25,8,18,0,18,79.39,0
Nonozle,2022-08-12,8,18,0,18,79.39,3
Mech Shuffle,2022-07-29,4,18,0,18,79.39,0
Kiss the Demiurge,2022-12-02,5,18,0,18,79.39,0
Unscramble Heroes,2022-10-02,29,18,0,18,79.39,0
Early Worm,2022-11-10,2,18,0,18,79.39,0
Prehistoric Kingdom,2022-04-27,2520,1488,309,1797,79.37,56
Citizens: Far Lands,2022-07-15,75,84,10,94,79.37,4
Zenith MMO,2022-01-27,4629,3003,656,3659,79.36,41
Turbo Sliders Unlimited,2022-04-27,80,66,7,73,79.35,4
Moonstuck,2022-04-14,27,123,17,140,79.32,0
Notes From Province,2022-08-13,25,47,4,51,79.32,5
Gravity Ace,2022-05-26,4,26,1,27,79.32,0
Kukoos - Lost Pets,2022-12-06,6,26,1,27,79.32,0
Otteretto,2022-01-29,7,26,1,27,79.32,1
Boat Crew,2022-08-01,7,26,1,27,79.32,0
Snowyland,2022-01-14,2,26,1,27,79.32,0
Siege of Treboulain,2022-04-14,35,26,1,27,79.32,0
Notebook Entries Vol. 1,2022-11-11,3,26,1,27,79.32,0
All the Words She Wrote,2022-03-08,8,26,1,27,79.32,0
Gravitar: Recharged,2022-06-02,5,26,1,27,79.32,0
Through the Kill Screen,2022-04-20,8,26,1,27,79.32,0
Mr.Brocco & Co,2022-09-10,11,26,1,27,79.32,0
Crystal Winter,2022-12-17,108,26,1,27,79.32,0
Christmas Luge,2022-12-23,4,26,1,27,79.32,0
Hentai Christmas,2022-12-24,8,26,1,27,79.32,1
SCP: 5K - Alpha Testing,2022-02-22,497,2946,645,3591,79.31,72
Bean Stalker,2022-06-06,28,171,26,197,79.31,8
Last Days of Lazarus,2022-06-22,20,89,11,100,79.28,0
FLERP,2022-09-09,252,242,40,282,79.27,0
Immortal Tactics: War of the Eternals,2022-07-15,28,83,10,93,79.25,0
To Make a Game,2022-02-12,3,53,5,58,79.25,0
Kitty May Cry,2022-11-14,34,53,5,58,79.25,0
Riftbound,2022-05-12,30,40,3,43,79.25,1
Rasetsu Fumaden,2022-08-13,19,40,3,43,79.25,1
Bad Faith,2022-02-04,8,40,3,43,79.25,0
INCUR Survival,2022-12-13,37,40,3,43,79.25,8
No Place Like Home,2022-03-17,1344,2540,554,3094,79.24,57
Pocket Stables,2022-09-26,231,77,9,86,79.23,19
风色幻想6:冒险奏鸣,2022-08-09,82,77,9,86,79.23,11
ZOR: Pilgrimage of the Slorfs,2022-08-30,33,33,2,35,79.23,0
Move 78,2022-08-03,6,33,2,35,79.23,0
DnD Adventure: Wizard's Choice,2022-06-15,9,33,2,35,79.23,2
Outside the Window,2022-09-15,6,33,2,35,79.23,0
How To Bathe Your Cat: Impossible Mission,2022-01-20,5,33,2,35,79.23,0
Chronescher,2022-08-31,8,33,2,35,79.23,0
The Chaput's Baby,2022-09-26,4,33,2,35,79.23,0
Fit Puzzle Blocks,2022-09-20,5,33,2,35,79.23,2
Tile Town,2022-10-13,8,33,2,35,79.23,0
Warlocks Quarry,2022-08-31,15,59,6,65,79.22,0
The Trench,2022-10-12,4,65,7,72,79.21,1
No More Heroes 3,2022-10-11,241,290,50,340,79.19,5
Aquarist,2022-03-08,146,362,65,427,79.17,14
Hyperbolica,2022-03-14,591,848,170,1018,79.16,1
NEON STRUCT: Desperation Column,2022-01-20,7,46,4,50,79.14,0
Dolmenjord - Viking Islands,2022-11-17,12,46,4,50,79.14,0
Roll Player,2022-05-20,26,46,4,50,79.14,4
轮回修仙路,2022-12-02,1851,921,187,1108,79.11,170
Buriedbornes - Dungeon RPG,2022-12-14,993,585,113,698,79.1,38
Annie and the Art Gallery,2022-04-12,19,115,16,131,79.1,3
The Manga Works,2022-07-25,272,115,16,131,79.1,9
体育館の天井に挟まったマッチョを助けるゲーム,2022-06-28,27,76,9,85,79.1,0
Crush the Castle Legacy Collection,2022-03-29,28,70,8,78,79.08,2
Last Night of Winter,2022-08-09,11,52,5,57,79.08,0
Mechanibot,2022-08-31,21,52,5,57,79.08,0
Countess in Crimson,2022-05-18,214,277,48,325,79.06,11
ARRIVAL: ZERO EARTH,2022-10-11,54,64,7,71,79.06,4
Heliotropism,2022-03-24,20,64,7,71,79.06,1
Bad Cat,2022-03-02,11,64,7,71,79.06,2
Infinite Stars - The Visual Novel,2022-09-29,31,58,6,64,79.06,1
Jester`s Theater Museum,2022-06-10,30,58,6,64,79.06,0
Witch 3 Return,2022-10-06,56,58,6,64,79.06,0
Mary Skelter 2,2022-01-13,47,87,11,98,79.05,6
Nyanco Impact,2022-11-11,12,87,11,98,79.05,1
Lux Ex,2022-06-17,3,17,0,17,79.05,0
Donut Arena,2022-03-18,6,17,0,17,79.05,0
Elearning Development Intern,2022-11-30,6,17,0,17,79.05,0
Gastova: The Witches of Arkana,2022-12-07,7,17,0,17,79.05,0
SUPER UFO FIGHTER,2022-07-13,27,17,0,17,79.05,0
Afterthought,2022-08-01,4,17,0,17,79.05,0
Hapland Trilogy,2022-12-14,14,17,0,17,79.05,0
Pale Night,2022-06-20,7,17,0,17,79.05,0
Reflection,2022-09-29,3,17,0,17,79.05,0
Dorfs,2022-06-21,7,17,0,17,79.05,0
MACE: Mapinguari's Temple,2022-04-29,16,17,0,17,79.05,0
Space Ballers,2022-08-01,3,17,0,17,79.05,0
Heroes of Book & Paper,2022-05-18,3,17,0,17,79.05,0
Wilderplace,2022-09-09,5,17,0,17,79.05,0
Hellfire 1988: An Oregon Story,2022-05-11,4,17,0,17,79.05,0
The Adventures of Mr. Hat,2022-02-25,7,17,0,17,79.05,0
Num One: Revised Edition,2022-03-02,6,17,0,17,79.05,1
Pow! 2,2022-03-07,3,17,0,17,79.05,0
Nightfall Comes,2022-04-22,5,17,0,17,79.05,0
Bash The Party,2022-07-22,2,17,0,17,79.05,0
INTRAQUARTZ,2022-07-19,2,17,0,17,79.05,0
风墓战记,2022-05-16,4,17,0,17,79.05,0
Lamoneo,2022-05-25,2,17,0,17,79.05,0
Aery - Vikings,2022-07-22,9,17,0,17,79.05,0
Blaze in Space: Beat a-maze,2022-10-18,7,17,0,17,79.05,0
City Limits,2022-08-05,4,17,0,17,79.05,0
Yukar From The Abyss,2022-11-14,5,17,0,17,79.05,0
Buy Hyacinths,2022-08-30,4,17,0,17,79.05,0
The Fantastic Kitty Rue,2022-12-16,2,17,0,17,79.05,0
Card Cowboy,2022-10-04,4,17,0,17,79.05,0
Masarada Town Story,2022-11-09,5,17,0,17,79.05,0
Oakenfold,2022-11-17,7,39,3,42,79.04,0
Dr. Kobushi's Labyrinthine Laboratory,2022-09-15,8,39,3,42,79.04,0
Lila's Tale and The Hidden Forest,2022-11-10,6,25,1,26,79.04,1
Brendan Keogh's Putting Challenge,2022-02-25,8,25,1,26,79.04,0
BOX RUSH 2: Ice worlds,2022-05-18,5,25,1,26,79.04,0
BDSM Apocalypse,2022-05-30,8,25,1,26,79.04,0
Woodlock Manor,2022-07-31,7,25,1,26,79.04,0
Project Gunship,2022-08-31,24,247,42,289,79.03,0
The Heart of Darkness,2022-04-16,342,197,32,229,79.02,3
Cat Saves Halloween,2022-10-13,11,32,2,34,78.99,1
No Cat Fights Here,2022-04-29,7,32,2,34,78.99,0
CORPSE FACTORY,2022-05-31,120,347,63,410,78.98,3
One More Gate: A Wakfu Legend,2022-10-11,554,171,27,198,78.97,10
Police Response VR Disturbance,2022-04-06,6,75,9,84,78.97,0
Predecessor,2022-12-01,7339,4306,989,5295,78.95,848
Deliver Us From Evil,2022-03-02,10,45,4,49,78.95,0
Yerr Out,2022-10-17,29,45,4,49,78.95,0
Sentimental K,2022-01-18,116,279,49,328,78.94,1
Drill Deal - Oil Tycoon,2022-03-09,128,97,13,110,78.93,1
Asphalt 9: Legends,2022-08-02,999,3351,761,4112,78.92,880
*NEW* SCUFFED BHOP SIMULATION 2026 GOTY EDITION,2022-03-25,53,160,25,185,78.92,1
Teenage Mutant Ninja Turtles: The Cowabunga Collection,2022-08-30,379,406,76,482,78.91,9
Watcher Chronicles,2022-01-19,37,113,16,129,78.91,2
Fairyside,2022-11-01,26,63,7,70,78.91,0
Barro GT,2022-05-19,24,123,18,141,78.86,2
OkIPullUp,2022-12-12,22,123,18,141,78.86,1
Construction Simulator,2022-09-20,17365,4551,1056,5607,78.85,"1,202"
Hellstuck: Rage With Your Friends,2022-05-27,77,107,15,122,78.85,9
Nympho's Path,2022-07-15,40,107,15,122,78.85,1
Kao the Kangaroo,2022-05-27,404,482,93,575,78.83,20
Cosmos Bit,2022-03-11,5,38,3,41,78.83,0
Arclight Beat,2022-05-26,25,38,3,41,78.83,0
4X4,2022-10-05,16,38,3,41,78.83,2
Paragon Pioneers,2022-09-29,51,38,3,41,78.83,6
Drift King,2022-07-28,31,133,20,153,78.82,0
Extra Case: My Girlfriend's Secrets,2022-09-12,11,85,11,96,78.82,1
Nine Noir Lives,2022-09-07,22,68,8,76,78.8,0
Voor de kroon,2022-12-09,17,68,8,76,78.8,1
Love Money Rock'n'Roll,2022-08-04,4153,4464,1039,5503,78.79,66
Electrician Simulator - First Shock,2022-01-06,566,1393,301,1694,78.79,18
停留此刻 Stay in the moment,2022-06-03,13,117,17,134,78.79,0
Floppy Knights,2022-05-24,143,183,30,213,78.77,2
Deepening Fire,2022-11-29,204,251,44,295,78.76,2
Three Kingdoms : Hero,2022-04-01,47,79,10,89,78.76,4
Cracking the Cryptic,2022-08-01,96,79,10,89,78.76,35
La Pucelle: Ragnarok,2022-08-30,71,44,4,48,78.75,4
Boo Party,2022-10-24,14,24,1,25,78.75,1
Wavecade,2022-07-10,4,24,1,25,78.75,0
DRAWER,2022-01-27,6,24,1,25,78.75,0
Ryzer: The Reflectors Path,2022-01-20,5,24,1,25,78.75,0
GRADUATER,2022-04-05,7,24,1,25,78.75,0
PopSlinger,2022-04-14,4,24,1,25,78.75,0
Madville+,2022-08-23,7,24,1,25,78.75,0
Animal Trail ☆ Girlish Square,2022-08-12,9,24,1,25,78.75,0
 Castle of Full Moon 月圆之堡,2022-08-27,4,24,1,25,78.75,0
Intergalactic Taxi Co.,2022-05-31,4,24,1,25,78.75,0
Walking In The Abyss,2022-10-17,2,24,1,25,78.75,0
Dusk Diver 2,2022-01-14,35,56,6,62,78.74,0
Cubes and Knights,2022-05-04,8,56,6,62,78.74,1
Zemblanity,2022-04-03,8,56,6,62,78.74,0
Ultimate Protector,2022-09-27,8,56,6,62,78.74,1
Swordbreaker: Origins,2022-05-13,13,31,2,33,78.74,0
Mini Maker: Make A Thing,2022-06-28,10,31,2,33,78.74,0
CAT Interstellar: Recast,2022-02-04,6,31,2,33,78.74,0
Faded Stories: Greenberg,2022-06-18,10,31,2,33,78.74,0
A Butterfly's Dream,2022-04-04,4,31,2,33,78.74,0
GoBangTetris,2022-03-06,18,31,2,33,78.74,2
Demon Go!,2022-09-08,5,31,2,33,78.74,0
PIEN-ぴえん- & PAON-ぱおん- plus,2022-12-06,14,31,2,33,78.74,0
Adorable Witch 4 ：Lust,2022-09-08,78,312,57,369,78.73,3
Unsouled,2022-04-27,37,202,34,236,78.73,3
Nevermore: The Chamber Door,2022-06-15,5,50,5,55,78.73,0
Light,2022-10-19,20,50,5,55,78.73,0
Light,2022-10-19,20,50,5,55,78.73,0
Light,2022-10-19,20,50,5,55,78.73,0
Light,2022-08-19,2,6,1,7,66.62,0
Light,2022-08-19,2,6,1,7,66.62,0
Light,2022-08-19,2,6,1,7,66.62,0
Light,2014-07-14,41,197,144,341,56.43,0
Light,2014-07-14,41,197,144,341,56.43,0
Light,2014-07-14,41,197,144,341,56.43,0
Abort Retry Fail,2022-05-17,5,50,5,55,78.73,0
Noelle Does Her Best!,2022-08-13,384,255,45,300,78.72,13
异世界无厘头生活2,2022-04-22,50,142,22,164,78.72,0
Goat's Tale,2022-01-17,248,269,48,317,78.71,0
Luckitown,2022-01-19,66,157,25,182,78.71,3
Sakura Succubus 5,2022-04-04,27,73,9,82,78.71,1
Crystal Clash,2022-01-14,1163,911,191,1102,78.7,11
Your Love Story 被你忘记的那个夏天,2022-08-19,10,116,17,133,78.7,0
Nightmare Hunter,2022-08-20,102,84,11,95,78.7,1
Nightmare Hunter,2022-08-20,102,84,11,95,78.7,0
Nightmare Hunter,2022-08-20,102,84,11,95,78.7,0
Nightmare Hunter,2022-08-16,1,3,0,3,67.06,1
Nightmare Hunter,2022-08-16,1,3,0,3,67.06,0
Nightmare Hunter,2022-08-16,1,3,0,3,67.06,0
Nightmare Hunter,2022-10-31,2,1,0,1,59.42,1
Nightmare Hunter,2022-10-31,2,1,0,1,59.42,0
Nightmare Hunter,2022-10-31,2,1,0,1,59.42,0
Neptunia x SENRAN KAGURA: Ninja Wars,2022-05-11,595,660,134,794,78.69,4
Tenko's Magical Sword Quest,2022-06-22,3,16,0,16,78.69,0
AlCHeMoS,2022-02-15,5,16,0,16,78.69,0
AST-Hero,2022-09-20,5,16,0,16,78.69,0
ReThink 4,2022-11-01,12,16,0,16,78.69,0
CIPHER 61,2022-01-06,5,16,0,16,78.69,0
Rolling Gunner,2022-12-21,6,16,0,16,78.69,0
A Walk With My Dog,2022-10-28,4,16,0,16,78.69,0
Unwell Known,2022-05-26,6,16,0,16,78.69,0
Blow & Fly,2022-05-03,2,16,0,16,78.69,0
A Day of Maintenance,2022-04-22,4,16,0,16,78.69,0
Dashpong,2022-10-28,5,16,0,16,78.69,0
The Alchemist Shop: An Apprentice's Life,2022-08-23,4,16,0,16,78.69,0
Sand: A Superfluous Game,2022-09-29,7,16,0,16,78.69,0
Laboratory,2022-01-24,4,16,0,16,78.69,0
Buggy Game,2022-03-09,4,16,0,16,78.69,0
Stairway to Heaven's Gate,2022-01-21,8,16,0,16,78.69,0
Gav-Gav Odyssey,2022-01-26,3,16,0,16,78.69,0
Astrogon,2022-09-30,6,16,0,16,78.69,0
Reimei no Gakuen - Otome/Visual Novel,2022-02-11,13,16,0,16,78.69,2
Cleaning The System,2022-08-30,9,16,0,16,78.69,1
B-RAIN,2022-03-01,3,16,0,16,78.69,0
毛玉大冒险 ~ Kedama's Adventure,2022-08-23,6,16,0,16,78.69,0
散落之瓣：華 - Falling Petals: Bloom Edition,2022-07-02,8,16,0,16,78.69,0
YUMMY CHICKEN DRAGON,2022-04-20,3,16,0,16,78.69,0
The Secret Life of Dorian Pink (Prologue),2022-05-14,2,16,0,16,78.69,0
MeiQi:Story,2022-05-13,19,16,0,16,78.69,0
Music Man,2022-06-16,3,16,0,16,78.69,0
Light Them Up,2022-07-15,6,16,0,16,78.69,1
Epic Astro Story,2022-10-11,30,16,0,16,78.69,1
焰色方糖 flamed sugar,2022-07-20,3,16,0,16,78.69,0
TrainFormation,2022-08-19,4,16,0,16,78.69,0
Dawn of Kagura: Maika's Story - The Dragon's Wrath,2022-09-30,5,16,0,16,78.69,0
Lonely White,2022-08-26,8,16,0,16,78.69,0
The Travel Game,2022-09-01,9,16,0,16,78.69,0
Hidden Shapes - Cat Realm,2022-11-16,5,16,0,16,78.69,1
Flawless,2022-10-06,4,16,0,16,78.69,0
Routemania,2022-11-01,6,16,0,16,78.69,0
Strip n Play with Valerie,2022-10-15,9,16,0,16,78.69,0
Seventh Star,2022-12-24,5,16,0,16,78.69,0
Born Punk,2022-06-18,40,100,14,114,78.68,2
Dreamland,2022-10-31,222,755,156,911,78.65,28
Dreamland,2022-10-31,222,755,156,911,78.65,0
Dreamland,2022-06-29,2,6,1,7,66.62,28
Dreamland,2022-06-29,2,6,1,7,66.62,0
The Ice Caves,2022-04-11,15,136,21,157,78.65,0
Bananner Nababber,2022-08-13,11,67,8,75,78.65,1
祖玛少女,2022-05-01,239,487,96,583,78.61,3
Last Slice,2022-04-20,19,61,7,68,78.61,0
Hell Division,2022-06-03,199,61,7,68,78.61,0
The Pointless Car Chase: Refueled,2022-02-22,6,37,3,40,78.6,1
Blast Off Far Away,2022-07-23,11,37,3,40,78.6,0
Chevalier Historie,2022-02-26,415,257,46,303,78.59,5
Zombie Cure Lab,2022-12-07,412,185,31,216,78.59,25
Crowns and Pawns: Kingdom of Deceit,2022-05-06,125,252,45,297,78.58,4
东方远空界 ~ Ultimate Vitality of Imagination,2022-02-07,95,55,6,61,78.57,0
Bass Monkey,2022-06-02,10,55,6,61,78.57,0
Salome's Kiss,2022-04-26,12,55,6,61,78.57,0
My Coworker Is An Idiot,2022-12-08,8,55,6,61,78.57,0
AdventureQuest 3D,2022-10-28,2098,6609,1592,8201,78.56,357
Pro Cycling Manager 2022,2022-06-09,3263,449,88,537,78.55,"1,750"
Arcane Vale,2022-12-16,65,104,15,119,78.55,4
Camp Focus,2022-01-26,13,49,5,54,78.55,0
Warplan Pacific,2022-03-17,15,49,5,54,78.55,3
PolyCore Defense,2022-07-21,27,43,4,47,78.55,0
Platonic,2022-05-13,17,43,4,47,78.55,0
TAISHO x ALICE: HEADS & TAILS,2022-07-27,52,43,4,47,78.55,3
面具古墓,2022-10-31,33,43,4,47,78.55,0
Plunder Panic,2022-09-16,678,462,91,553,78.54,3
DREAMWILD,2022-10-31,12,88,12,100,78.53,0
Memoirs of a Battle Brothel,2022-09-30,146,114,17,131,78.51,3
Raifu Wars,2022-02-22,18,66,8,74,78.51,0
苍白花树繁茂之时Blood Flowers,2022-11-03,16,66,8,74,78.51,0
Game Dev Masters,2022-06-03,25,119,18,137,78.5,5
REPLIKATOR,2022-05-11,37,77,10,87,78.5,2
Hot Hentai,2022-07-08,10,93,13,106,78.49,0
Parallel,2022-10-06,5,30,2,32,78.48,0
Catellite-609: feline space adventure,2022-07-27,7,30,2,32,78.48,0
Dead End Aegis,2022-01-14,7,30,2,32,78.48,0
Loplight,2022-07-18,4,30,2,32,78.48,0
Chromosome Evil,2022-03-24,107,212,37,249,78.47,6
Dream House Days DX,2022-03-28,87,183,31,214,78.46,9
One More Dungeon 2,2022-09-19,44,98,14,112,78.46,1
Beltex,2022-07-08,74,98,14,112,78.46,3
红月,2022-10-15,36,60,7,67,78.45,0
Ghost on the Shore,2022-02-24,23,103,15,118,78.44,0
Running Fable,2022-11-04,6,23,1,24,78.44,0
A Way To Die,2022-05-13,4,23,1,24,78.44,0
The Pentest,2022-12-16,7,23,1,24,78.44,0
Dungeon Lad,2022-03-31,6,23,1,24,78.44,0
Traction Control,2022-03-28,6,23,1,24,78.44,0
Timeline,2022-04-22,8,23,1,24,78.44,0
Project Xenoflora,2022-02-17,5,23,1,24,78.44,0
SEARCH ALL - RUNES,2022-02-22,3,23,1,24,78.44,0
Polar Penguin Post,2022-11-30,16,23,1,24,78.44,0
Neko Loop,2022-12-23,5,23,1,24,78.44,0
ColorCube,2022-07-14,3,23,1,24,78.44,0
S.E.C.U.,2022-11-02,3,23,1,24,78.44,0
NekoNecro,2022-10-31,7,23,1,24,78.44,0
Cats in Heat,2022-08-25,7,23,1,24,78.44,0
Ship of Fools,2022-11-22,2324,1615,363,1978,78.43,100
Out of the Park Baseball 23,2022-04-22,1855,773,163,936,78.43,671
You Suck at Parking,2022-09-14,110,168,28,196,78.43,36
Time Lock VR 2,2022-07-13,12,71,9,80,78.43,0
Young Souls,2022-03-10,261,350,67,417,78.42,1
Super Bullet Break,2022-08-12,226,230,41,271,78.42,4
The Jackbox Party Pack 9,2022-10-20,2337,386,75,461,78.41,59
SCP: Vacation,2022-03-03,9,113,17,130,78.41,0
Smilemo,2022-05-19,83,435,86,521,78.4,4
Shadow Racer,2022-05-19,46,138,22,160,78.4,0
Daggan,2022-05-30,29,54,6,60,78.4,1
Otoko Cross: Pretty Boys Klondike Solitaire,2022-07-14,10,54,6,60,78.4,0
Prison Life,2022-09-23,786,1474,330,1804,78.39,148
FurryFury,2022-04-14,1029,1118,245,1363,78.38,7
WARNO,2022-01-20,2113,4104,980,5084,78.37,765
MuseSwipr,2022-12-21,69,196,34,230,78.37,4
Lullaby days,2022-01-28,22,76,10,86,78.37,1
Santhai,2022-01-13,106,76,10,86,78.37,1
Cupid Story: First Date,2022-01-07,8,36,3,39,78.37,1
第一千零二夜的童话,2022-01-25,6,36,3,39,78.37,0
Playable Mockup,2022-05-25,50,48,5,53,78.36,0
My Truck Game,2022-02-07,20,152,25,177,78.34,1
In Nightmare,2022-11-29,15,42,4,46,78.34,1
隐秘的原罪8,2022-07-29,33,42,4,46,78.34,0
みなも流し,2022-09-09,12,42,4,46,78.34,0
Isolated Room,2022-12-16,8,42,4,46,78.34,0
Another Farm Roguelike,2022-11-30,147,200,35,235,78.33,16
Sketch Crawler,2022-11-14,55,147,24,171,78.33,1
Quatro!,2022-11-14,70,112,17,129,78.32,1
MMX: Otherworld Mystery - Expanded Edition,2022-11-09,8,15,0,15,78.3,0
Edengrall,2022-01-07,4,15,0,15,78.3,0
Uncle Nook's Monster Emporium,2022-04-28,2,15,0,15,78.3,0
Squish,2022-06-28,15,15,0,15,78.3,0
Totally Convenient,2022-03-04,1,15,0,15,78.3,0
Stolen Crown,2022-10-13,6,15,0,15,78.3,0
Hype Prototype,2022-10-31,4,15,0,15,78.3,0
Cheftastic!: Buffet Blast,2022-02-03,9,15,0,15,78.3,0
Threaded,2022-02-10,6,15,0,15,78.3,0
Saffron Fields,2022-03-03,4,15,0,15,78.3,0
TEN,2022-06-03,6,15,0,15,78.3,0
A Maze Fox,2022-01-21,3,15,0,15,78.3,0
Naughty Waifu,2022-02-17,3,15,0,15,78.3,0
Headland,2022-07-26,6,15,0,15,78.3,0
Spinning Maze,2022-01-20,3,15,0,15,78.3,0
Spinning Maze,2022-01-20,3,15,0,15,78.3,0
Spinning Maze,2016-10-17,8,14,2,16,71.52,0
Spinning Maze,2016-10-17,8,14,2,16,71.52,0
Dark Flame,2022-01-20,9,15,0,15,78.3,0
Slayer,2022-06-01,10,15,0,15,78.3,0
Slidetracked,2022-03-19,5,15,0,15,78.3,0
Jigsaw Souls,2022-02-11,3,15,0,15,78.3,0
Amelite,2022-03-25,13,15,0,15,78.3,0
Mathletix,2022-02-07,3,15,0,15,78.3,0
ShapeGrid,2022-04-04,4,15,0,15,78.3,0
Guns N Stuff 2,2022-07-12,19,15,0,15,78.3,0
Winter With You,2022-01-31,3,15,0,15,78.3,0
13 Steps,2022-10-18,4,15,0,15,78.3,0
Koni: The Secrets of Castle,2022-03-09,3,15,0,15,78.3,0
Space Piercer,2022-03-07,3,15,0,15,78.3,0
Raven,2022-05-29,3,15,0,15,78.3,0
Boxel Golf,2022-08-01,6,15,0,15,78.3,0
We See You,2022-08-19,3,15,0,15,78.3,0
Tomorrow for Mar,2022-05-31,2,15,0,15,78.3,0
Is It You?,2022-11-08,17,15,0,15,78.3,0
Square Journey,2022-06-01,3,15,0,15,78.3,0
GUTTER: The Cursed,2022-10-21,3,15,0,15,78.3,0
Keep it Cool Man,2022-07-28,4,15,0,15,78.3,0
Paper Flight - Speed Rush,2022-11-11,9,15,0,15,78.3,0
Space Rescue,2022-06-20,3,15,0,15,78.3,0
Fanatic Zeal,2022-06-24,3,15,0,15,78.3,0
DracoFighter,2022-07-07,5,15,0,15,78.3,0
Sokorun: one box,2022-08-05,3,15,0,15,78.3,0
Keyboard Warrior: Dreamstate,2022-07-23,2,15,0,15,78.3,0
Puzzline,2022-11-04,86,15,0,15,78.3,3
Planet Surfer,2022-12-14,3,15,0,15,78.3,0
Drakkon World Builder,2022-09-01,4,15,0,15,78.3,1
The Villager and the Werewolf - A jigsaw puzzle tale,2022-10-26,4,15,0,15,78.3,0
The Heart of the Teddy Bear,2022-12-06,3,15,0,15,78.3,0
与魔共舞,2022-12-15,9,15,0,15,78.3,1
Hell Runner,2022-12-08,4,15,0,15,78.3,0
Antioch : Scarlet Bay,2022-11-25,83,151,25,176,78.26,6
Digimon Survive,2022-07-28,6179,2014,466,2480,78.24,46
Zodiac fantasy 2,2022-11-24,95,111,17,128,78.22,2
MH-Zombie,2022-03-28,6,53,6,59,78.22,1
Locked Up,2022-03-31,7,53,6,59,78.22,1
Locked Up,2022-03-31,7,53,6,59,78.22,2
Locked Up,2020-04-24,42,751,194,945,75.72,1
Locked Up,2020-04-24,42,751,194,945,75.72,2
Moon Runner,2022-10-21,20,160,27,187,78.21,1
SEARCH ALL - CHRISTMAS,2022-01-10,5,29,2,31,78.21,0
SEARCH ALL - MUSHROOMS,2022-03-01,3,29,2,31,78.21,0
Winter tramp,2022-05-24,4,29,2,31,78.21,0
The Lord of Isekai Brothels,2022-10-20,39,29,2,31,78.21,1
Craft Hero,2022-10-10,349,281,53,334,78.2,11
Space Wreck,2022-12-05,50,64,8,72,78.2,0
Pompom,2022-03-14,23,64,8,72,78.2,0
Yummy Girl 2,2022-04-08,8,64,8,72,78.2,0
_keyboardkommander,2022-12-21,20,80,11,91,78.19,0
SEARCH ALL - CATS,2022-02-09,4,80,11,91,78.19,0
MECH PUNK,2022-11-24,7,47,5,52,78.16,0
Symbiotic,2022-05-16,40,130,21,151,78.14,0
A Mage Reborn,2022-08-04,61,69,9,78,78.14,2
Inua,2022-02-10,10,35,3,38,78.13,0
Franchise Hockey Manager 9,2022-11-08,253,110,17,127,78.12,155
DEEP 8,2022-06-17,3,22,1,23,78.11,0
OverShoot Battle Race,2022-04-14,6,22,1,23,78.11,0
Camellia Train,2022-05-13,7,22,1,23,78.11,0
Quest Of Graal,2022-02-04,7,22,1,23,78.11,0
Icemaze Cave: Skate Escape,2022-05-18,7,22,1,23,78.11,0
Tower of Spirit,2022-07-12,4,22,1,23,78.11,0
Cold Land,2022-05-26,3,22,1,23,78.11,0
Hop Step Sing! VR Live Hop☆Summer 2nd,2022-08-02,7,22,1,23,78.11,0
A Most Extraordinary Gnome,2022-12-08,5,22,1,23,78.11,0
Chacara,2022-10-19,5,22,1,23,78.11,0
Hentai Pussy 5,2022-12-09,2,22,1,23,78.11,0
rote²(RoteSquare),2022-04-03,10,74,10,84,78.09,0
Angry Angry Shark,2022-01-02,250,219,40,259,78.08,0
Monster Hunter Rise: Sunbreak Demo,2022-06-15,27540,849,186,1035,78.07,34
WorldMaker,2022-09-02,20,79,11,90,78.06,0
Milk Bottle And Monster Girl 2,2022-04-05,56,214,39,253,78.05,1
Station Manager,2022-03-28,107,153,26,179,78.04,12
名酱三国,2022-12-02,44,84,12,96,78.04,11
Decisive Campaigns: Ardennes Offensive,2022-02-10,33,63,8,71,78.04,9
Dying Light 2,2022-02-04,274983,101975,27328,129303,78.03,"5,707"
バレットフィリア達の闇市場　〜 100th Black Market.,2022-08-14,1660,383,77,460,78.01,3
缄默咖啡厅,2022-10-15,22,99,15,114,78.01,0
Strategic Command: American Civil War,2022-07-14,214,94,14,108,78.01,33
VAIL,2022-11-17,256,845,186,1031,78.0,37
Oblivity,2022-03-24,1064,791,173,964,78.0,75
Devil's Dungeon,2022-02-04,108,208,38,246,77.97,1
Unconventional Warfare,2022-04-21,13,46,5,51,77.96,0
99 Fails Lite,2022-06-15,13,46,5,51,77.96,0
魔塔三国之群雄争霸,2022-06-24,48,46,5,51,77.96,2
Idle Spiral,2022-04-30,2214,838,185,1023,77.95,453
Indoorlands,2022-10-14,74,147,25,172,77.95,6
Deadburg,2022-03-15,19,73,10,83,77.95,0
Glitchhikers: The Spaces Between,2022-03-31,12,73,10,83,77.95,0
Guardener,2022-06-21,33,73,10,83,77.95,0
Bound by Love,2022-01-08,531,394,80,474,77.94,3
Heat and Run,2022-10-13,14,28,2,30,77.92,0
Dungeons of Voidria,2022-07-28,15,28,2,30,77.92,0
Instinct War,2022-12-15,6,28,2,30,77.92,0
Takkoman -Kouzatsu World-,2022-05-02,7,28,2,30,77.92,0
Killer Worm 2,2022-01-18,2,28,2,30,77.92,0
URUBU,2022-04-25,10,28,2,30,77.92,0
BLOCKED ZONA,2022-05-18,4,28,2,30,77.92,0
Atama,2022-10-13,12,28,2,30,77.92,0
Mutagenic,2022-08-09,14,28,2,30,77.92,0
惡魔調酒師,2022-07-12,316,252,48,300,77.9,26
Buccaneers!,2022-03-07,138,225,42,267,77.9,1
Martha Is Dead,2022-02-24,750,1863,440,2303,77.89,23
Shatterline,2022-09-08,21760,20153,5272,25425,77.88,"1,200"
Immortal Life,2022-04-28,2952,1719,404,2123,77.88,87
Divinia Chronicles: Relics of Gan-Ti,2022-09-18,96,62,8,70,77.88,0
Ninja JaJaMaru: The Great Yokai Battle + Hell,2022-05-11,17,34,3,37,77.88,0
6-Mon Adventure,2022-06-10,6,34,3,37,77.88,0
俠之道(PathOfWuxia),2022-11-15,16175,23204,6096,29300,77.87,169
Nummels,2022-06-21,4,14,0,14,77.87,0
In Retrospect,2022-09-07,3,14,0,14,77.87,0
Sky Squadron,2022-12-14,4,14,0,14,77.87,0
Muslim 3D,2022-02-21,4,14,0,14,77.87,0
Shell Out Showdown,2022-04-04,7,14,0,14,77.87,0
Urban Mage,2022-03-08,2,14,0,14,77.87,0
Toaster Defense,2022-05-23,3,14,0,14,77.87,0
Tokyo Rogue,2022-07-15,4,14,0,14,77.87,0
The Chronos Principle,2022-03-02,3,14,0,14,77.87,0
Mini Golf Worlds VR,2022-01-11,4,14,0,14,77.87,0
Bugged Dungeon,2022-02-22,5,14,0,14,77.87,0
Move Dodge and Kill,2022-01-27,2,14,0,14,77.87,0
GASERB,2022-01-28,4,14,0,14,77.87,0
怪盗ミューのシークレットプリマ,2022-10-13,3,14,0,14,77.87,0
回家 - Homeward,2022-02-23,2,14,0,14,77.87,0
Halloween is Crazy as Hell,2022-05-11,5,14,0,14,77.87,0
Tales From The Under-Realm: After Midnight,2022-10-07,13,14,0,14,77.87,0
SGS Pacific D-Day,2022-04-28,7,14,0,14,77.87,0
Blood Bay: Card History,2022-12-14,2,14,0,14,77.87,0
Sad Ghouls,2022-03-18,4,14,0,14,77.87,0
Wormhole,2022-03-30,4,14,0,14,77.87,0
Brothers,2022-03-11,4,14,0,14,77.87,0
Furry Hentai Quest,2022-03-07,4,14,0,14,77.87,0
Dragons On Desktop,2022-03-04,4,14,0,14,77.87,0
SNOT,2022-04-01,3,14,0,14,77.87,0
Spider Slingers,2022-08-12,10,14,0,14,77.87,0
Ambulance Emergency Simulation,2022-04-25,4,14,0,14,77.87,0
Alkali,2022-11-10,4,14,0,14,77.87,0
Seasons,2022-11-11,2,14,0,14,77.87,0
Seasons,2022-11-11,2,14,0,14,77.87,0
Seasons,2022-05-31,1,2,0,2,64.08,0
Seasons,2022-05-31,1,2,0,2,64.08,0
梦境魔法意志,2022-08-17,3,14,0,14,77.87,0
Life is Paradise,2022-06-08,11,14,0,14,77.87,0
Before the explosion,2022-07-11,2,14,0,14,77.87,0
Meteorites 3D,2022-12-16,6,14,0,14,77.87,0
Jack Big Chin: Alien Invasion,2022-09-29,4,14,0,14,77.87,0
Oh Sheep!,2022-10-14,6,14,0,14,77.87,0
Oh Sheep!,2022-10-14,6,14,0,14,77.87,0
Oh Sheep!,2022-09-14,3,7,0,7,73.26,0
Oh Sheep!,2022-09-14,3,7,0,7,73.26,0
Radial Flow,2022-08-01,6,14,0,14,77.87,0
MeMoMi,2022-11-21,2,14,0,14,77.87,0
TAMAKAGURA: Tales of Turmoil,2022-08-26,5,14,0,14,77.87,0
The Perfect Garden,2022-08-16,2,14,0,14,77.87,0
阴桃花,2022-12-01,2,14,0,14,77.87,0
Bunny Eureka,2022-10-20,3,14,0,14,77.87,0
Pixelmancer,2022-10-14,3,14,0,14,77.87,0
Cards with Personalities,2022-11-18,4,14,0,14,77.87,0
Sands of Slumber: The RPG,2022-11-23,7,14,0,14,77.87,1
Spartacus: Born to be free,2022-11-20,3,14,0,14,77.87,0
Rootless: Memories Of Green,2022-12-12,4,14,0,14,77.87,0
Arcanium,2022-09-22,316,528,112,640,77.86,17
Cygnus,2022-12-16,119,197,36,233,77.86,13
Adventure in My Head,2022-03-10,7,174,31,205,77.86,0
Freud's Bones-the game,2022-05-25,21,51,6,57,77.85,1
Blank Frame,2022-01-28,10,51,6,57,77.85,0
Maid PizzaHub,2022-05-20,6,51,6,57,77.85,0
Sweety kitty,2022-10-10,7,51,6,57,77.85,0
Wheel of Innocence,2022-10-24,11,51,6,57,77.85,0
Crafty Survivors - Prologue,2022-11-17,124,51,6,57,77.85,0
Queen's Wish 2: The Tormentor,2022-08-24,128,67,9,76,77.84,3
Kibbi Keeper,2022-03-04,55,136,23,159,77.82,0
Wandering in space VR,2022-06-30,14,136,23,159,77.82,0
DON'T LOOK AWAY,2022-10-16,28,112,18,130,77.82,0
DeadPoly,2022-01-12,1067,3143,770,3913,77.81,105
Electrician Simulator,2022-09-21,998,968,219,1187,77.81,123
CARNAGE OFFERING,2022-04-29,6,150,26,176,77.81,0
MATH EXPRESSions,2022-04-21,32,131,22,153,77.8,0
The Imperial Gatekeeper,2022-09-03,1115,828,185,1013,77.79,19
Project Vostok,2022-07-19,12,77,11,88,77.79,0
Furry Cyberfucker II,2022-07-23,682,92,14,106,77.78,0
Fore Score,2022-07-12,7,21,1,22,77.77,0
Contract Killer,2022-05-19,5,21,1,22,77.77,0
Scholar of the Arcane Arts,2022-12-15,6,21,1,22,77.77,1
Aeternum Vale,2022-10-05,4,21,1,22,77.77,0
Skyscraper Jump,2022-05-13,4,21,1,22,77.77,0
Dwarfenstein,2022-05-13,4,21,1,22,77.77,0
Delta Manifold,2022-08-22,5,21,1,22,77.77,0
SEARCH ALL - BIRDS,2022-06-11,3,21,1,22,77.77,1
The Stone Cutter and the Mountain Spirit,2022-11-15,3,21,1,22,77.77,0
Train Operator 377,2022-12-02,7,21,1,22,77.77,0
Chess Royale,2022-11-16,9,21,1,22,77.77,0
Project Playtime,2022-12-12,21105,20020,5277,25297,77.76,"2,557"
Recursive Ruin,2022-05-18,31,140,24,164,77.76,0
SEARCH ALL - BERRIES,2022-02-25,6,45,5,50,77.75,0
Forgotten Hill Tales,2022-04-27,42,45,5,50,77.75,3
Trash Horror Collection 2,2022-09-20,7,45,5,50,77.75,0
American Theft 80s: Prologue,2022-03-08,617,557,120,677,77.74,10
Ultimechs,2022-09-15,39,116,19,135,77.74,0
Demeo - PC Edition,2022-12-15,345,489,104,593,77.72,89
First Date : Late To Date,2022-08-19,49,383,79,462,77.72,3
Attacker-chan!,2022-08-09,26,61,8,69,77.72,0
First Snow,2022-12-10,18,61,8,69,77.72,0
First Snow,2022-12-10,18,61,8,69,77.72,2
First Snow,2020-08-19,57,516,31,547,87.69,0
First Snow,2020-08-19,57,516,31,547,87.69,2
Thy Creature,2022-11-15,43,106,17,123,77.7,1
Sniper Elite 5,2022-05-26,14870,8114,2089,10203,77.69,"2,354"
灵途,2022-01-20,71,125,21,146,77.69,0
The Book of Warriors,2022-09-24,70,153,27,180,77.68,5
妖刀退魔忍,2022-09-16,57,139,24,163,77.68,2
Anomalous,2022-01-11,11,66,9,75,77.68,0
Realms of Magic,2022-07-20,773,641,141,782,77.67,33
Space Block Buster,2022-09-05,10,39,4,43,77.67,0
Heck Deck,2022-01-11,10,39,4,43,77.67,0
Furry Love & Sex,2022-10-22,36,39,4,43,77.67,0
Nazi Furry,2022-05-21,647,120,20,140,77.66,0
怪物狩猎：序章,2022-12-15,27,81,12,93,77.65,0
AGNI,2022-10-03,61,50,6,56,77.65,0
Project Downfall,2022-12-01,22,264,52,316,77.62,1
Out of Bounds,2022-12-16,4,33,3,36,77.62,0
茶叶蛋大冒险,2022-06-14,48,33,3,36,77.62,0
PewPew Live,2022-09-10,10,33,3,36,77.62,0
Torii,2022-11-17,7,27,2,29,77.62,0
Teabat!,2022-03-03,10,27,2,29,77.62,0
Yumeiri,2022-03-02,10,27,2,29,77.62,1
Skylost,2022-05-30,7,27,2,29,77.62,0
Live Maze,2022-08-31,11,27,2,29,77.62,0
Hentai Nurse,2022-11-26,5,27,2,29,77.62,0
Meteor Volleyball!,2022-01-07,36,124,21,145,77.59,0
Touhou Library Survivors,2022-10-14,22,55,7,62,77.59,1
KAMIMAHOU,2022-01-28,49,285,57,342,77.58,0
大侠请重来,2022-06-14,955,2203,538,2741,77.57,1
Train Sim World® 3,2022-09-06,1796,1849,447,2296,77.56,891
Warlords Under Siege,2022-12-02,264,219,42,261,77.56,15
恋来い温泉物語VR,2022-10-11,40,95,15,110,77.55,1
Kynseed,2022-12-06,2304,1870,453,2323,77.54,122
Rise Of The White Sun,2022-09-26,16,44,5,49,77.54,2
Entity Researchers,2022-03-02,42,44,5,49,77.54,0
Shoot Trip Die,2022-05-06,9,44,5,49,77.54,0
My Doctor is a Futanari,2022-02-25,5,44,5,49,77.54,0
Battlerace,2022-06-28,10,44,5,49,77.54,0
Doomed to Hell,2022-03-25,18,128,22,150,77.53,2
Ultra Age,2022-04-27,68,196,37,233,77.52,1
Serial Cleaners,2022-09-22,132,151,27,178,77.52,2
Aviator: Air Combat,2022-11-23,5,85,13,98,77.52,0
Northend Tower Defense,2022-03-08,215,560,123,683,77.51,5
Dread X Collection 5,2022-05-20,128,169,31,200,77.51,0
Monster Girl Dormitory,2022-08-19,18,137,24,161,77.51,0
Splat Cat,2022-06-18,12,75,11,86,77.51,0
Nurose,2022-01-07,15,70,10,80,77.51,0
Fencing Girl,2022-01-12,8,70,10,80,77.51,0
索罗灵魂之戒,2022-03-18,37,123,21,144,77.5,1
Power to the People,2022-02-08,342,283,57,340,77.49,15
SEX with HITLER,2022-01-22,2001,1967,480,2447,77.48,7
Stellar Monarch 2,2022-10-03,29,49,6,55,77.45,3
Nude In The Castle,2022-06-11,3,49,6,55,77.45,0
TRIANGLE STRATEGY,2022-10-13,2489,1133,267,1400,77.44,340
Castle of secrets: Prologue,2022-11-18,142,230,45,275,77.44,1
Within Skerry,2022-02-08,26,159,29,188,77.44,0
TrinityS,2022-04-28,269,113,19,132,77.44,6
Apotheorasis,2022-05-12,3,38,4,42,77.43,0
Lost Alone Ep.2 - Paparino,2022-05-15,6,38,4,42,77.43,1
Return to the Skyway,2022-09-03,11,38,4,42,77.43,0
Mobmania,2022-08-18,126,190,36,226,77.42,30
HoneySelect2Libido DX,2022-06-03,491,686,155,841,77.41,105
YYDS成神之路,2022-09-25,3,13,0,13,77.41,0
sfäre,2022-01-11,4,13,0,13,77.41,0
The Star Legation,2022-02-04,4,13,0,13,77.41,0
Midnight Manor,2022-10-01,3,13,0,13,77.41,0
Dark Romance: Vampire Origins Collector's Edition,2022-07-15,12,13,0,13,77.41,0
RiffleEffect,2022-11-24,9,13,0,13,77.41,0
Dragon Saddle Melee,2022-01-26,20,13,0,13,77.41,0
青鳥樂園 Blue Bird Land EP.1 上篇,2022-10-25,3,13,0,13,77.41,0
Weirdlands,2022-12-23,6,13,0,13,77.41,0
OrbWars,2022-04-29,7,13,0,13,77.41,0
Laika,2022-11-03,3,13,0,13,77.41,0
Dave Dave Dave,2022-01-15,4,13,0,13,77.41,0
Pingo's Revenge,2022-05-24,2,13,0,13,77.41,0
Box to the Box,2022-05-20,5,13,0,13,77.41,0
Great Marble Adventure,2022-02-11,8,13,0,13,77.41,0
极简地牢 Simple Killer,2022-01-21,4,13,0,13,77.41,0
Porcelana,2022-01-22,4,13,0,13,77.41,0
Jetbounce,2022-02-11,3,13,0,13,77.41,0
Hunt-or-Haunt,2022-01-29,27,13,0,13,77.41,0
月影待蚀The Incomplete Lunar,2022-01-11,12,13,0,13,77.41,1
Dimension Quest Pinball,2022-02-13,3,13,0,13,77.41,0
Fluids & Sounds: Mind relaxing and meditative,2022-02-03,4,13,0,13,77.41,0
SnackHunter,2022-07-08,5,13,0,13,77.41,0
Sandream,2022-12-01,2,13,0,13,77.41,0
Mixed Feelings: While You Were Away,2022-03-24,4,13,0,13,77.41,0
Quick Words,2022-03-23,4,13,0,13,77.41,0
Swords & Bones 2,2022-05-09,4,13,0,13,77.41,0
Forget-me-not,2022-04-17,4,13,0,13,77.41,0
Dungeon Rummage - Tiqee's Escape,2022-04-29,2,13,0,13,77.41,0
My Therapist is a Futanari 2,2022-10-17,4,13,0,13,77.41,0
The Accursed Crown of the Giant King,2022-08-08,5,13,0,13,77.41,1
Survive 10 Minutes Please,2022-06-02,3,13,0,13,77.41,0
Putinator,2022-06-15,3,13,0,13,77.41,0
Alice's Warped Wonderland:REcollection,2022-09-02,16,13,0,13,77.41,0
Motorbike Video Puzzle,2022-07-29,2,13,0,13,77.41,0
JB Hunter: Adventure,2022-12-30,5,13,0,13,77.41,0
Klitorax,2022-10-18,2,13,0,13,77.41,0
My Mad Scientist Roommate Turned Me Into Her Personal Robotic Battle Maiden?!?,2022-12-09,9,13,0,13,77.41,1
Out of the Cube,2022-10-21,4,13,0,13,77.41,0
SokoMelody,2022-12-19,4,13,0,13,77.41,0
A Clockwork Ley-Line: Flowers Falling in the Morning Mist,2022-11-11,17,13,0,13,77.41,0
Budgie Genetics Simulator,2022-11-02,4,13,0,13,77.41,0
Vs Chat Pack,2022-10-13,4,13,0,13,77.41,0
ナツキリー夏休みは切島邸にて,2022-11-16,4,13,0,13,77.41,0
Osminog Adventure - The Lost Island,2022-12-09,4,13,0,13,77.41,0
Out of the ground,2022-12-13,3,13,0,13,77.41,0
Raiders of Ruin,2022-12-02,4,13,0,13,77.41,0
Swarm the City: Full Release Prologue,2022-05-11,356,163,30,193,77.4,1
Twice Reborn: a vampire visual novel,2022-06-16,8,20,1,21,77.4,0
The Sunny Life,2022-07-21,10,20,1,21,77.4,0
RUNOUT,2022-03-08,3,20,1,21,77.4,0
EchoBlade,2022-05-03,3,20,1,21,77.4,0
 Wordeous,2022-08-22,10,20,1,21,77.4,0
No Fair Play,2022-09-09,46,20,1,21,77.4,0
News Reacts,2022-05-20,5,20,1,21,77.4,0
堕天者 ~Back to Origin~,2022-03-22,8,20,1,21,77.4,0
Mirrorama,2022-01-12,3,20,1,21,77.4,0
Bad Credit,2022-02-17,6,20,1,21,77.4,0
Diptych: The Great War,2022-05-12,2,20,1,21,77.4,0
Cryptid Coffeehouse,2022-08-12,4,20,1,21,77.4,0
Silent World,2022-06-02,3,20,1,21,77.4,0
Silent World,2022-06-02,3,20,1,21,77.4,0
Silent World,2020-03-19,3,6,14,20,38.0,0
Silent World,2020-03-19,3,6,14,20,38.0,0
Fly By Knight,2022-06-18,3,20,1,21,77.4,0
HEN CHICKS AND CATS,2022-06-17,3,20,1,21,77.4,0
Catlike Magic,2022-09-03,3,20,1,21,77.4,0
Terracotta,2022-11-14,47,84,13,97,77.39,0
The Witch's Sexual Prison,2022-01-25,149,534,118,652,77.37,1
Fabular: Once upon a Spacetime,2022-11-10,106,103,17,120,77.37,2
Once Ever After,2022-10-14,98,103,17,120,77.37,1
MegaFactory Titan,2022-02-23,34,74,11,85,77.36,4
Red Valley,2022-05-09,6,74,11,85,77.36,0
Screeps: Arena,2022-04-07,202,69,10,79,77.36,2
Mess Adventures 2,2022-01-26,46,69,10,79,77.36,1
Isle of Jura,2022-02-11,7,69,10,79,77.36,0
Marauders,2022-10-03,14332,10696,2844,13540,77.34,530
Evasion from Hell,2022-04-23,5,32,3,35,77.34,0
EvoMon,2022-12-15,15,32,3,35,77.34,0
Desperate: Vladivostok,2022-11-03,5,43,5,48,77.32,0
Paper Wizards,2022-09-04,17,43,5,48,77.32,0
My Stepbro is a Femboy,2022-08-11,15,266,54,320,77.3,0
Rogueslide,2022-02-22,7,26,2,28,77.3,0
Invader TD,2022-09-05,5,26,2,28,77.3,0
Nineteen,2022-01-21,6,26,2,28,77.3,0
Hovercars 3077: Underground,2022-05-19,3,26,2,28,77.3,0
Kuroi Tsubasa,2022-04-04,5,26,2,28,77.3,0
Pwnk,2022-04-22,109,26,2,28,77.3,0
KAWAII SLIME ARENA,2022-05-20,4,26,2,28,77.3,0
Galactic Wars EX,2022-04-21,5,26,2,28,77.3,0
Moonrakers: Luminor,2022-07-23,175,26,2,28,77.3,2
Forgotten Realms: The Archives - Collection Three,2022-03-29,26,26,2,28,77.3,2
Hoverboy,2022-07-11,4,26,2,28,77.3,0
Cursed Crops,2022-10-03,12,26,2,28,77.3,1
hOrnyWars,2022-01-12,14,139,25,164,77.28,0
Project Crypt,2022-05-13,14,125,22,147,77.25,1
Deliverance,2022-04-08,63,134,24,158,77.24,23
Deliverance,2022-04-08,63,134,24,158,77.24,0
Deliverance,2015-08-31,8,13,14,27,48.83,23
Deliverance,2015-08-31,8,13,14,27,48.83,0
Artist Life Simulator,2022-12-13,24,78,12,90,77.24,2
发现姐姐是妹控的我今后该如何是好,2022-07-01,4,78,12,90,77.24,0
Stargazing: Genesis,2022-03-29,46,111,19,130,77.23,1
Holy Shit,2022-05-27,7,165,31,196,77.22,0
Hentai Girls: Contact [18+],2022-03-04,10,73,11,84,77.22,0
Hanyo,2022-09-24,40,213,42,255,77.21,1
Mechanic 8230: Escape from Ilgrot,2022-04-13,8,53,7,60,77.21,1
DEATHRUN TV,2022-06-01,21,53,7,60,77.21,1
Fayburrow,2022-02-03,35,264,54,318,77.2,1
Endlanders : First Encounter,2022-06-04,350,178,34,212,77.2,1
Lila’s Sky Ark,2022-04-21,15,68,10,78,77.2,1
Demonheart: The Ice Demon,2022-11-14,104,58,8,66,77.2,3
Gold Drill,2022-09-14,24,58,8,66,77.2,1
Wigmund,2022-03-28,382,364,78,442,77.19,14
Last Group Out,2022-02-18,12,63,9,72,77.19,1
Jack Move,2022-09-08,209,405,88,493,77.18,1
Nightmare: The Lunatic,2022-01-07,20,37,4,41,77.18,0
QUICKERFLAK_RUTHLESSMOD,2022-06-10,4,37,4,41,77.18,0
Rune Factory 5,2022-07-13,2690,914,216,1130,77.16,174
Warhammer 40000: Chaos Gate - Daemonhunters,2022-05-05,12455,6852,1816,8668,77.15,"1,349"
Warbox Sandbox,2022-06-24,23,124,22,146,77.15,4
Marvel's Midnight Suns,2022-12-02,15500,8852,2369,11221,77.14,"2,388"
Isle of Arrows,2022-09-08,598,489,109,598,77.14,58
Project Warlock II,2022-06-10,139,350,75,425,77.12,2
Warriors: Rise to Glory,2022-01-20,345,726,169,895,77.1,4
Porcelain Tales,2022-02-04,132,266,55,321,77.09,10
我反对这门亲事-I'm against this marriage,2022-05-22,14,42,5,47,77.09,0
Conductor: Creative Joy Engine,2022-03-27,10,42,5,47,77.09,0
Just Ignore Them: Brea's Story Tape 1,2022-03-29,5,42,5,47,77.09,1
Knotwords,2022-04-28,40,42,5,47,77.09,2
PARADISE CLEANING - pregnant ogre -,2022-08-26,7,42,5,47,77.09,0
River City Girls 2,2022-12-15,833,697,162,859,77.07,19
Mech Armada,2022-06-16,395,361,78,439,77.07,8
Dank Subs,2022-05-10,32,114,20,134,77.06,0
Hatchwell,2022-05-13,10,31,3,34,77.06,0
Trophy Chaser,2022-12-27,4,31,3,34,77.06,0
Old World,2022-05-19,3589,1674,417,2091,77.05,420
HerrAnwalt: Lawyers Legacy,2022-11-04,419,393,86,479,77.05,1
Potion Permit,2022-09-22,4894,2362,601,2963,77.04,189
Super SplashTube Bros.,2022-04-12,13,47,6,53,77.04,0
One Night With Stalin,2022-03-19,7,145,27,172,77.03,1
Citywars Tower Defense,2022-03-04,347,608,140,748,77.02,39
Speedway Challenge 2022,2022-06-08,79,52,7,59,77.02,14
Cyber Slayer,2022-10-08,10,52,7,59,77.02,0
Blade Assault,2022-01-18,721,1438,356,1794,77.0,18
Burger Patrol,2022-02-15,7,19,1,20,77.0,0
Phaseshift,2022-03-08,4,19,1,20,77.0,0
Josh Journey: Darkness Totems,2022-10-15,5,19,1,20,77.0,0
Obscurant,2022-04-29,4,19,1,20,77.0,0
Doki Doki Ragnarok,2022-02-14,9,19,1,20,77.0,0
Cthulhu pub,2022-07-24,5,19,1,20,77.0,1
Cloaks and Capes,2022-10-14,5,19,1,20,77.0,0
Rock 'n' Roll Will Never Die!,2022-04-28,5,19,1,20,77.0,0
YOGA MASTER,2022-01-03,3,19,1,20,77.0,1
モールス信号で愛を伝えよ。,2022-05-29,7,19,1,20,77.0,0
Dirty Girls,2022-03-23,3,19,1,20,77.0,1
Psychosis,2022-12-20,3,19,1,20,77.0,0
Chess but...,2022-08-30,18,19,1,20,77.0,0
Magazine Mogul,2022-09-05,22,19,1,20,77.0,2
First Bite,2022-02-14,35,81,13,94,76.99,3
捉妖物语/Monster Girl,2022-07-16,87,399,88,487,76.98,0
Nadir - Prologue,2022-03-22,46,140,26,166,76.98,1
Remorse: The List,2022-04-22,33,153,29,182,76.97,1
Best Forklift Operator,2022-08-11,37,153,29,182,76.97,0
街机捕鱼嘉年华,2022-02-14,38,131,24,155,76.97,0
COVID Kawaii!,2022-12-26,5,25,2,27,76.97,0
How I learned to Skate,2022-06-24,6,25,2,27,76.97,0
Tiny Island,2022-12-09,4,25,2,27,76.97,0
Build Lands,2022-08-04,5,25,2,27,76.97,0
EvoluShip,2022-11-23,4,25,2,27,76.97,1
Match Village,2022-10-20,22,25,2,27,76.97,0
Make Love Not War,2022-09-27,8,25,2,27,76.97,0
Koa: The Forgotten Gods,2022-08-08,4,25,2,27,76.97,0
OneBit Adventure,2022-08-19,278,251,52,303,76.96,28
蔚蓝月下的回忆~SAPPHIRE MOON-FOREVER MEMORIES,2022-09-24,67,255,53,308,76.95,0
Fire & Maneuver,2022-07-15,1780,1597,400,1997,76.93,51
Snowman Adventure,2022-01-03,4,36,4,40,76.92,0
Utomah,2022-10-29,5,36,4,40,76.92,0
Sweet Office,2022-07-29,21,108,19,127,76.91,0
LEGIONCRAFT,2022-08-19,1324,1066,260,1326,76.9,5
Bounce Paradise,2022-03-11,15,12,0,12,76.9,0
Woodland Empire,2022-10-19,8,12,0,12,76.9,0
Rocket Drift,2022-06-24,2,12,0,12,76.9,0
The Royal Game of Ur 3D,2022-04-09,7,12,0,12,76.9,0
A Bad Game Of Football,2022-09-27,25,12,0,12,76.9,0
Belle Boomerang,2022-06-03,6,12,0,12,76.9,0
Ergo VR,2022-05-09,3,12,0,12,76.9,0
Ricochet Ranger,2022-05-20,3,12,0,12,76.9,0
Birb Race,2022-06-29,3,12,0,12,76.9,0
Move that Box!,2022-08-06,3,12,0,12,76.9,0
Homunculus Hotel,2022-03-03,3,12,0,12,76.9,0
Horoscopicus,2022-10-20,4,12,0,12,76.9,0
Commuter,2022-03-04,3,12,0,12,76.9,0
QuaQua,2022-02-04,3,12,0,12,76.9,0
Project Kunai,2022-01-29,6,12,0,12,76.9,0
Le Avventure di Blue,2022-12-06,4,12,0,12,76.9,0
Xross Dreams,2022-12-25,14,12,0,12,76.9,0
Pirates on Target,2022-01-22,2,12,0,12,76.9,0
Eyo - Jump 'n' Run RPG,2022-11-04,3,12,0,12,76.9,0
Arboreal,2022-02-03,6,12,0,12,76.9,0
Arboreal,2022-02-03,6,12,0,12,76.9,0
Arboreal,2022-02-03,6,12,0,12,76.9,0
Arboreal,2021-12-01,3,0,2,2,35.92,0
Arboreal,2021-12-01,3,0,2,2,35.92,0
Arboreal,2021-12-01,3,0,2,2,35.92,0
Arboreal,2018-07-16,14,19,11,30,58.59,0
Arboreal,2018-07-16,14,19,11,30,58.59,0
Arboreal,2018-07-16,14,19,11,30,58.59,0
Pieces of Beauty 3,2022-02-13,3,12,0,12,76.9,0
Spirit of Shotgun,2022-03-11,5,12,0,12,76.9,0
Cleopatra Fortune™ S-Tribute,2022-11-23,12,12,0,12,76.9,0
Spe:X,2022-05-18,2,12,0,12,76.9,0
星际神格,2022-05-04,4,12,0,12,76.9,0
Elite School Roof Club!,2022-03-27,5,12,0,12,76.9,0
Mini Putt,2022-11-12,11,12,0,12,76.9,0
夏日相册,2022-06-10,3,12,0,12,76.9,0
Demons Happened,2022-07-25,3,12,0,12,76.9,0
FIRE HEAT,2022-05-26,8,12,0,12,76.9,0
AN IOU,2022-11-13,2,12,0,12,76.9,0
The Patient: After Hours,2022-07-15,3,12,0,12,76.9,0
Sissa's Path,2022-08-09,4,12,0,12,76.9,0
听不到你的话语的我，想要静静聆听你的心,2022-08-30,3,12,0,12,76.9,0
无极修仙传·序章,2022-10-20,4,12,0,12,76.9,0
Department of the Devil,2022-10-24,3,12,0,12,76.9,0
Super DynoStory,2022-11-09,3,12,0,12,76.9,0
Gravity Box,2022-09-23,5,12,0,12,76.9,0
Mr. White,2022-11-06,4,12,0,12,76.9,0
Hack & Schlitz,2022-09-30,8,12,0,12,76.9,0
Word,2022-11-12,5,12,0,12,76.9,0
Spooky Halloween in the Voxel World,2022-10-31,3,12,0,12,76.9,0
Morrow,2022-10-21,3,12,0,12,76.9,0
World Zero,2022-10-12,3,12,0,12,76.9,0
Argol - Kronoss' Castle,2022-12-25,4,12,0,12,76.9,0
Super Planet Life,2022-12-01,5,12,0,12,76.9,2
Pretty Girls 2048 Strike,2022-12-02,6,12,0,12,76.9,0
List: Game of Candles,2022-12-02,3,12,0,12,76.9,0
Femboy Bangers 2,2022-09-22,6,66,10,76,76.88,0
Hero's Hour,2022-03-01,4265,2939,766,3705,76.85,260
Dr. Professor Scientist's Weapons Testing Facility,2022-03-08,48,61,9,70,76.85,1
Zombie Slaughter VR,2022-05-11,4,41,5,46,76.85,0
Climber: Sky is the Limit - Free Trial,2022-07-19,629,215,44,259,76.82,0
Femboys & Fries,2022-08-18,13,125,23,148,76.82,3
Sakura Succubus 6,2022-07-11,26,51,7,58,76.82,0
HVS: Hitler VS Stalin,2022-11-01,4,51,7,58,76.82,0
Furry Sex,2022-03-18,9,285,61,346,76.81,0
Psych,2022-10-22,34,198,40,238,76.81,0
Psych,2022-10-22,34,198,40,238,76.81,0
Psych,2020-09-30,2,10,6,16,57.17,0
Psych,2020-09-30,2,10,6,16,57.17,0
Spacelines from the Far Out - Captain's Prologue,2022-02-07,124,181,36,217,76.8,2
NecroBouncer,2022-12-08,62,75,12,87,76.8,0
Clown For Speed,2022-06-30,11,75,12,87,76.8,0
KartKraft,2022-01-26,206,2250,581,2831,76.78,63
Right and Down,2022-10-18,122,129,24,153,76.78,11
Kingdom of Atham: Crown of the Champions,2022-01-07,96,214,44,258,76.76,9
Stardom 2000,2022-03-31,295,120,22,142,76.76,10
Hex Rally Racers,2022-05-20,17,84,14,98,76.76,0
MAFIA: Family's Secret,2022-01-08,31,30,3,33,76.76,0
Tad the Lost Explorer,2022-11-15,13,30,3,33,76.76,3
Presenter Slides™,2022-08-01,10,30,3,33,76.76,0
wurdweb,2022-11-01,16,30,3,33,76.76,0
The Swarm,2022-11-25,13,30,3,33,76.76,1
Best Month Ever!,2022-05-05,30,111,20,131,76.75,1
Astronite - Landing on Neplea,2022-09-08,20,111,20,131,76.75,0
Please Subscribe,2022-02-10,38,93,16,109,76.74,0
Apostle: Rebellion,2022-07-30,473,201,41,242,76.73,4
Fairy Biography2：Confidante,2022-11-24,129,205,42,247,76.72,0
SEX with HITLER 3D,2022-11-05,382,209,43,252,76.71,0
Festival Tycoon,2022-05-04,82,137,26,163,76.71,3
Wings of Glory,2022-07-21,29,65,10,75,76.71,1
Neko Maid,2022-02-11,13,115,21,136,76.7,1
Motherless - Season 1,2022-09-01,242,343,76,419,76.69,33
Infinite Tao,2022-11-30,2588,559,131,690,76.68,43
Stardom 2,2022-03-31,638,221,46,267,76.68,5
Otoko Cross: Pretty Boys Mahjong Solitaire,2022-05-19,38,88,15,103,76.68,1
XP Soccer,2022-11-11,17,74,12,86,76.65,0
BAD DREAMS,2022-12-16,6,35,4,39,76.65,1
SnOut 2,2022-02-22,14,35,4,39,76.65,0
Hot Springs Story 2,2022-12-19,96,35,4,39,76.65,21
Axiom Verge 2,2022-08-11,136,249,53,302,76.64,3
The medical examination diary: the exciting days of me and my senpai,2022-05-05,19,55,8,63,76.64,0
FURRY CYBERSEX,2022-07-16,38,55,8,63,76.64,0
Moonbreaker,2022-09-29,882,491,114,605,76.63,6
Kainga,2022-12-06,238,440,101,541,76.62,27
百詰怪軼與金魚,2022-01-13,15,24,2,26,76.62,0
Fingun,2022-03-18,5,24,2,26,76.62,0
Menu Please!,2022-01-21,5,24,2,26,76.62,0
Legacy of Sin blood oath,2022-09-01,4,24,2,26,76.62,0
Two Colours,2022-06-01,8,24,2,26,76.62,0
IMAGO: Beyond the Nightmares,2022-09-30,5,24,2,26,76.62,0
勇者联盟星耀传说,2022-09-30,9,24,2,26,76.62,1
A Tale of Paper,2022-08-19,16,50,7,57,76.61,0
Britannia,2022-07-07,15,40,5,45,76.61,4
Dungeon Wizards,2022-02-04,63,40,5,45,76.61,2
Zombie Death Quota,2022-05-13,9,40,5,45,76.61,0
Hentai DarkElf,2022-11-14,5,40,5,45,76.61,0
Hohokum,2022-07-28,24,45,6,51,76.6,1
BornWild • Versus S1 - Prologue,2022-06-18,9,45,6,51,76.6,0
Vampire: The Masquerade - Heartless Lullaby,2022-04-21,38,211,44,255,76.58,0
C.A.R.L.,2022-09-29,12,18,1,19,76.58,0
SUPEROLA CHAMPION EDITION,2022-07-14,3,18,1,19,76.58,0
Hero Lodge,2022-01-12,9,18,1,19,76.58,0
Out of Order,2022-03-16,4,18,1,19,76.58,0
The Soul Stone War 2,2022-01-13,45,18,1,19,76.58,0
Rabbit Meadow,2022-03-01,3,18,1,19,76.58,0
Telestians,2022-06-16,3,18,1,19,76.58,0
Tiles and Towers TD,2022-12-07,5,18,1,19,76.58,0
Egg Ascent,2022-05-02,3,18,1,19,76.58,0
The Night of Death,2022-05-14,4,18,1,19,76.58,0
Link The Cubes,2022-11-11,4,18,1,19,76.58,0
Aery - Last Day of Earth,2022-10-24,5,18,1,19,76.58,0
禁忌taboo,2022-08-26,4,18,1,19,76.58,0
Platformity,2022-06-20,5,18,1,19,76.58,0
MMI,2022-11-20,2,18,1,19,76.58,0
Skate Rift,2022-11-01,4,18,1,19,76.58,1
Snuff,2022-09-05,4,18,1,19,76.58,0
Hoshizora no Memoria -Eternal Heart- HD,2022-11-18,9,18,1,19,76.58,0
Long and Hard... Summer!,2022-12-15,136,78,13,91,76.56,13
Tricking 0,2022-03-31,46,148,29,177,76.55,3
Lost In Malul,2022-10-14,20,64,10,74,76.54,0
Viltnemda,2022-06-23,11,173,35,208,76.53,0
Aerofly FS 4 Flight Simulator,2022-07-04,52,214,45,259,76.51,25
Synthetic Lover,2022-01-13,18,59,9,68,76.49,1
The Iron Oath,2022-04-19,725,365,83,448,76.47,25
Umichan Sorani,2022-05-27,14,29,3,32,76.45,0
Another Tomorrow,2022-02-14,11,29,3,32,76.45,1
Super Shooter,2022-02-04,4,29,3,32,76.45,0
Grey Heritage: Faded Vision,2022-12-09,12,29,3,32,76.45,1
I Am Two People,2022-09-30,6,29,3,32,76.45,0
White Mirror,2022-08-26,7,29,3,32,76.45,1
White Mirror,2022-08-26,7,29,3,32,76.45,0
White Mirror,2016-01-27,1555,192,155,347,54.42,1
White Mirror,2016-01-27,1555,192,155,347,54.42,0
人生牌,2022-11-30,7,29,3,32,76.45,0
Office Management 101,2022-03-16,46,54,8,62,76.44,1
Retail Royale,2022-04-29,882,2715,725,3440,76.43,180
Technicity: Prologue,2022-08-10,64,95,17,112,76.43,4
DogeFight,2022-04-26,90,418,97,515,76.41,10
Sex with Teachers,2022-09-09,13,86,15,101,76.41,1
Ibatic,2022-01-17,13,49,7,56,76.4,0
Sparkling Memories,2022-10-28,81,125,24,149,76.39,0
依盖之书 book of yog,2022-07-30,4192,5401,1491,6892,76.38,"2,022"
Aroma,2022-12-09,46,171,35,206,76.38,1
Paranormal Detective: Escape from the 90s,2022-01-18,8,44,6,50,76.37,1
Milling machine simulator,2022-02-23,16,44,6,50,76.37,1
Lodventure,2022-12-12,51,44,6,50,76.37,0
Nightmare House 噩梦之馆,2022-06-20,7,34,4,38,76.37,0
Planetary Planter,2022-05-16,9,34,4,38,76.37,0
TRAFFIC,2022-09-02,4,34,4,38,76.37,0
Night Janitor,2022-09-20,5,39,5,44,76.35,1
Workaholic,2022-07-12,13,39,5,44,76.35,0
Hatup,2022-06-16,6,39,5,44,76.35,0
Fantasia Medieval,2022-10-14,8,39,5,44,76.35,0
A.W.O.L.,2022-09-16,136,485,115,600,76.34,7
The Last One Month,2022-01-13,46,81,14,95,76.34,0
Federation77,2022-10-06,12,72,12,84,76.34,0
Makiomino,2022-04-19,4,11,0,11,76.34,0
Hyperwheel Overdrive,2022-07-20,9,11,0,11,76.34,0
Angry Cat,2022-08-26,5,11,0,11,76.34,4
Kanso,2022-01-25,2,11,0,11,76.34,0
A Way Back,2022-04-29,3,11,0,11,76.34,0
Codename Prodigy,2022-12-27,4,11,0,11,76.34,0
My Personal Hilopet,2022-03-09,5,11,0,11,76.34,0
¡Arre Unicornio!,2022-03-18,6,11,0,11,76.34,0
Timore Redo,2022-07-26,4,11,0,11,76.34,0
Community College Hero: Fun and Games,2022-02-03,8,11,0,11,76.34,0
Me and my eldritch parasite,2022-04-29,2,11,0,11,76.34,0
Tether,2022-01-04,3,11,0,11,76.34,0
Mixx Island: Remix Vol. 2,2022-01-03,5,11,0,11,76.34,0
Pyramid Quest,2022-01-20,4,11,0,11,76.34,0
Claire's Cruisin' Cafe: High Seas Cuisine,2022-02-16,15,11,0,11,76.34,0
Eggroll,2022-01-26,2,11,0,11,76.34,0
Axiom of Maria,2022-03-03,4,11,0,11,76.34,0
Invasion From Space,2022-02-13,3,11,0,11,76.34,0
Barbarous 2 - Tavern Wars,2022-03-28,8,11,0,11,76.34,2
Pipe connect,2022-02-28,3,11,0,11,76.34,0
Looping Bravery,2022-09-28,2,11,0,11,76.34,0
The D-T.E.A.M.,2022-04-16,4,11,0,11,76.34,0
Project Angels,2022-07-14,7,11,0,11,76.34,0
The Dream Team,2022-06-01,7,11,0,11,76.34,0
Bargue,2022-06-17,12,11,0,11,76.34,0
Trash Pit,2022-04-15,5,11,0,11,76.34,0
Radon Break,2022-04-07,3,11,0,11,76.34,0
Easter Bunny,2022-04-05,2,11,0,11,76.34,0
Just a ball: jumping in the space,2022-04-16,2,11,0,11,76.34,0
Mineralis,2022-10-20,2,11,0,11,76.34,0
The Revenge of Mr.Samuel,2022-05-04,2,11,0,11,76.34,0
Let's Play Jigsaw Puzzles,2022-12-19,8,11,0,11,76.34,1
Lunaela,2022-05-13,4,11,0,11,76.34,0
Lone elven wanderer,2022-05-19,4,11,0,11,76.34,0
StoneDEF,2022-05-26,4,11,0,11,76.34,1
Treats Please!,2022-06-07,3,11,0,11,76.34,0
Ultimate Fighters,2022-06-10,4,11,0,11,76.34,0
Paper Flight - Super Speed Dash,2022-09-09,5,11,0,11,76.34,0
TargetPOP,2022-07-29,3,11,0,11,76.34,0
WUFO,2022-12-13,6,11,0,11,76.34,0
Streamer's Court,2022-07-21,10,11,0,11,76.34,0
Ailin: Traps and Treasures,2022-10-25,2,11,0,11,76.34,0
Panda Roll,2022-09-28,3,11,0,11,76.34,0
Stunts Contest Super Bike,2022-10-08,2,11,0,11,76.34,0
TOKKI,2022-11-21,2,11,0,11,76.34,0
Cabbagers,2022-12-21,12,11,0,11,76.34,0
Cuppy's,2022-11-30,4,11,0,11,76.34,0
Furious Sword,2022-11-17,4,11,0,11,76.34,0
The Awakening Program,2022-12-14,2,11,0,11,76.34,0
Twistingo: Bird Paradise Collector's Edition,2022-12-04,4,11,0,11,76.34,0
Ninety-Six,2022-12-24,2,11,0,11,76.34,0
Idle Monster TD: Evolved,2022-11-16,1085,737,182,919,76.33,752
Hats and Hand Grenades,2022-11-11,45,137,27,164,76.33,0
Bounty game,2022-12-23,1793,2585,694,3279,76.31,0
Jerez's Arena II,2022-04-29,226,141,28,169,76.31,2
Skábma™ - Snowfall,2022-04-22,29,85,15,100,76.28,0
Crowalt: Traces of the Lost Colony,2022-01-06,19,67,11,78,76.26,1
Cactus Cowboy - Plants at War,2022-05-03,12,67,11,78,76.26,2
Honey I Joined a Cult,2022-11-03,1161,936,237,1173,76.25,23
Dead Man's Fault,2022-11-30,3,23,2,25,76.25,0
Energy Island Corp.,2022-01-19,12,23,2,25,76.25,0
Chernobyl inferno,2022-01-17,5,23,2,25,76.25,0
Don't Get Tagged,2022-09-15,5,23,2,25,76.25,0
Lawnarchy,2022-03-29,5,23,2,25,76.25,0
Dead End City,2022-10-13,7,23,2,25,76.25,1
Tightrope Theatre,2022-08-11,4,23,2,25,76.25,0
맛있는 사랑,2022-04-29,8,23,2,25,76.25,0
Soccer But Different,2022-07-22,11,23,2,25,76.25,0
St. Yariman's Little Black Book ~Complete~,2022-11-01,12,23,2,25,76.25,1
Pocket Arcade Story,2022-09-26,31,23,2,25,76.25,2
Pink Explorer,2022-08-05,3,23,2,25,76.25,0
The Seven Realms - Realm 1,2022-11-17,171,115,22,137,76.24,7
Slaycation Paradise,2022-08-18,64,53,8,61,76.24,0
TRUFFLE,2022-01-07,6,53,8,61,76.24,0
BrVR Backrooms Virtual Reality,2022-07-15,7,53,8,61,76.24,0
建安外史 The Tales of Jian An,2022-11-01,72,106,20,126,76.19,5
Milk Bottle And Monster Girl,2022-01-13,61,315,72,387,76.18,2
Beastie Bay DX,2022-12-19,64,48,7,55,76.18,4
Hard West 2,2022-08-04,3058,1595,421,2016,76.17,56
EXOME,2022-12-16,66,156,32,188,76.17,1
ANNO:Mutationem,2022-03-17,2938,3216,883,4099,76.13,120
OverDrift Festival,2022-12-22,128,538,131,669,76.13,21
The Chant,2022-11-03,168,279,63,342,76.13,4
UNDETECTED,2022-09-30,12,43,6,49,76.13,0
Trinoline Genesis,2022-01-20,7,17,1,18,76.13,1
Defect Process,2022-12-01,4,17,1,18,76.13,0
toz,2022-06-10,4,17,1,18,76.13,0
Sea of Dreams,2022-04-15,2,17,1,18,76.13,0
Tengin Music Engine,2022-09-08,5,17,1,18,76.13,0
Eat Colors,2022-06-16,2,17,1,18,76.13,0
Square Farm,2022-10-27,20,17,1,18,76.13,0
...knew the beginning,2022-04-15,3,17,1,18,76.13,0
My Little Dictator,2022-06-06,12,17,1,18,76.13,0
Delivery in Space,2022-05-16,3,17,1,18,76.13,1
JAMPING FISH,2022-05-05,6,17,1,18,76.13,0
Chickenoidz Super Pre-Party,2022-09-07,21,17,1,18,76.13,0
Miners and Machines,2022-10-14,7,17,1,18,76.13,0
Dimensional Gears,2022-09-17,5,17,1,18,76.13,0
HellEscape,2022-09-18,8,17,1,18,76.13,0
魔塔三国之逆乱时空,2022-09-20,34,17,1,18,76.13,1
LALA Hentai,2022-11-27,4,17,1,18,76.13,0
Facteroids,2022-04-28,30,28,3,31,76.12,3
Cactus Simulator - Bofete Stories,2022-03-18,3,28,3,31,76.12,1
Hauling Away,2022-07-15,4,28,3,31,76.12,0
Further Still: Survivors,2022-09-19,11,28,3,31,76.12,0
QuentBlast,2022-09-28,8,28,3,31,76.12,0
Hentai DevilGirl,2022-12-02,6,28,3,31,76.12,0
Cataplexy,2022-01-12,4,38,5,43,76.09,0
Zorro The Chronicles,2022-06-16,15,38,5,43,76.09,0
Final Upgrade,2022-12-06,258,274,62,336,76.08,5
TVs: The Awakening,2022-07-28,3,33,4,37,76.08,0
恋~一些小清新的猎奇故事~,2022-03-30,15,126,25,151,76.07,0
ShadowBringer,2022-05-06,20,130,26,156,76.06,0
First Class Escape 2: Head in the Clouds,2022-02-08,43,109,21,130,76.05,9
Townsmen VR,2022-03-24,46,312,72,384,76.04,4
SGS Korean War,2022-10-27,24,52,8,60,76.03,0
Yu-Gi-Oh! Master Duel,2022-01-19,262689,45314,13536,58850,76.01,"19,613"
魔导圣战:风色幻想,2022-08-09,100,70,12,82,76.01,0
Tales of Yore,2022-03-28,56,198,43,241,76.0,17
Fadeout: Underground,2022-06-25,141,162,34,196,76.0,1
Vigorus,2022-03-03,17,61,10,71,76.0,0
Hidden Deep,2022-01-24,1226,2178,593,2771,75.97,30
Barro F22,2022-04-25,22,104,20,124,75.95,0
风色幻想5:赤月战争,2022-08-09,146,104,20,124,75.95,0
Neko Doll,2022-02-04,26,74,13,87,75.95,0
謎塔魔女,2022-03-01,20,47,7,54,75.95,0
NeuraGun,2022-01-21,199,47,7,54,75.95,0
Click Real Fast,2022-12-20,11,47,7,54,75.95,1
Roma Invicta,2022-02-11,17,141,29,170,75.93,0
LiBER,2022-01-11,8,65,11,76,75.92,0
Going Rogue,2022-11-11,65,65,11,76,75.92,7
Phil Alone,2022-07-22,11,91,17,108,75.91,0
Graduated,2022-07-29,321,301,70,371,75.89,1
HARVESTELLA,2022-11-04,3395,1202,318,1520,75.88,195
Mujun's Casefile ~ The Mystery Mansion ~,2022-02-17,46,42,6,48,75.88,0
Nightmare Knock,2022-12-14,22,42,6,48,75.88,4
Fabled Lands,2022-05-26,175,293,68,361,75.87,6
Requiem Of Science,2022-01-07,14,243,55,298,75.87,1
Midnight Ghost Hunt,2022-03-31,4987,4413,1250,5663,75.86,62
Trash is Fun,2022-07-05,8,22,2,24,75.86,0
Godless,2022-11-08,26,22,2,24,75.86,0
Lofi Furries,2022-06-16,4,22,2,24,75.86,0
Package Rush,2022-10-28,7,22,2,24,75.86,0
Abigor,2022-08-01,5,22,2,24,75.86,0
《蜀山：初章》买断版,2022-11-18,9202,5231,1492,6723,75.85,825
Re:BF,2022-03-12,432,188,41,229,75.85,4
Villa's Blinds,2022-01-27,20,164,35,199,75.84,0
ACTION SANDBOX,2022-04-22,203,589,148,737,75.82,10
Kingdom Under Fire: War of Heroes,2022-12-07,123,107,21,128,75.82,8
Halt The Heist!,2022-07-29,42,51,8,59,75.82,2
EL PASO NIGHTMARE,2022-10-25,14,51,8,59,75.82,0
London Ripper,2022-03-19,4,37,5,42,75.82,1
Kamiwaza: Way of the Thief,2022-10-11,64,37,5,42,75.82,1
Warrior Paint - 2005 GOTY Edition,2022-12-28,3,37,5,42,75.82,0
The Quarry,2022-06-10,6349,7148,2066,9214,75.81,283
Last Lovers 绿洲之爱,2022-03-04,17,111,22,133,75.8,0
Sycamore Free,2022-11-22,19,90,17,107,75.78,0
Neko Ghost Jump!,2022-01-11,8,32,4,36,75.77,0
MeiQi 2019,2022-11-03,11,32,4,36,75.77,0
Claris the Princess Knight,2022-05-06,15,32,4,36,75.77,2
Running on Magic,2022-07-15,5,32,4,36,75.77,0
Novi Cube,2022-09-22,58,32,4,36,75.77,0
Astonishing Baseball 22,2022-01-14,12,27,3,30,75.77,8
Chicken Fall,2022-09-22,44,27,3,30,75.77,0
Midnight at Forest,2022-03-06,3,27,3,30,75.77,0
Entropic Float: This World Will Decay And Disappear,2022-07-09,7,27,3,30,75.77,1
Hedgewars,2022-12-17,16,27,3,30,75.77,4
Monochrome Mobius: Rights and Wrongs Forgotten,2022-11-16,723,425,104,529,75.75,9
Incubus,2022-06-04,365,369,89,458,75.74,3
Tiny Tina's Wonderlands,2022-06-23,15021,7768,2264,10032,75.72,"2,503"
Cellyon: Boss Confrontation,2022-10-11,13,46,7,53,75.72,0
OLI,2022-03-29,9,46,7,53,75.72,0
Bot Gaiden,2022-04-22,3,10,0,10,75.71,0
Death Leak,2022-07-16,4,10,0,10,75.71,0
Listeria Wars,2022-12-08,4,10,0,10,75.71,0
LuPR: Lunar Post Recruit,2022-05-13,2,10,0,10,75.71,0
Space Captain McCallery - Episode 3: The Weaponmaster's Challenge,2022-07-05,2,10,0,10,75.71,0
Alder Forge,2022-01-07,5,10,0,10,75.71,0
JETMAN,2022-07-13,4,10,0,10,75.71,0
Dance Assembly,2022-12-08,3,10,0,10,75.71,0
Figurine Scene Simulator,2022-03-01,4,10,0,10,75.71,0
Venture Within,2022-05-29,3,10,0,10,75.71,0
Thomas' Tales,2022-06-16,2,10,0,10,75.71,0
The VII Enigma,2022-01-25,4,10,0,10,75.71,0
Multiply Factory,2022-07-27,14,10,0,10,75.71,0
YOKAIWARE,2022-01-03,2,10,0,10,75.71,0
Jump Challenge!,2022-03-19,4,10,0,10,75.71,0
Under The Warehouse,2022-03-23,2,10,0,10,75.71,0
Ball Boys,2022-09-22,8,10,0,10,75.71,0
Yonder World: Interview with the Void,2022-06-23,4,10,0,10,75.71,0
Action Ball,2022-03-14,3,10,0,10,75.71,0
Journey to the Heart of Gaia,2022-01-12,6,10,0,10,75.71,2
路地裏グローリーホール,2022-06-23,3,10,0,10,75.71,0
雷鸟Thunderbird,2022-10-10,4,10,0,10,75.71,0
Cyber Runner,2022-08-04,4,10,0,10,75.71,1
XenoTown,2022-08-17,3,10,0,10,75.71,0
A Ghostly Rose,2022-04-05,2,10,0,10,75.71,1
Trapped VR,2022-02-09,3,10,0,10,75.71,0
OOZEscape,2022-02-17,3,10,0,10,75.71,0
ToyCar,2022-08-04,10,10,0,10,75.71,0
Machine Gun Fury,2022-10-28,3,10,0,10,75.71,0
Run Away SkyDancer,2022-02-23,3,10,0,10,75.71,0
My Pet Rock,2022-05-02,7,10,0,10,75.71,0
My Pet Rock,2022-05-02,7,10,0,10,75.71,0
My Pet Rock,2017-01-23,915,25,8,33,66.85,0
My Pet Rock,2017-01-23,915,25,8,33,66.85,0
Memetric: Classic,2022-11-10,2,10,0,10,75.71,0
Eyeball Master,2022-04-01,10,10,0,10,75.71,0
John Christian 2,2022-06-14,3,10,0,10,75.71,0
You will die a lot buddy trust me!,2022-04-22,6,10,0,10,75.71,1
Overstrike Arena,2022-12-16,30,10,0,10,75.71,0
DEVIL DEVOUR ALIVE DX,2022-10-25,1,10,0,10,75.71,0
Santo Island Incident,2022-06-22,5,10,0,10,75.71,0
Until the Night,2022-06-06,88,10,0,10,75.71,0
Elena's Journal - Unfinished Expedition,2022-07-14,5,10,0,10,75.71,0
BeachRun,2022-05-25,3,10,0,10,75.71,0
Outpost Defender 2-Beta,2022-05-10,4,10,0,10,75.71,0
CROPPED,2022-06-10,4,10,0,10,75.71,0
The Legend of Chibi Ninja,2022-09-29,3,10,0,10,75.71,0
Was it a cat I saw?,2022-07-01,4,10,0,10,75.71,0
MonGirl Expedition,2022-12-15,8,10,0,10,75.71,0
วีรบุรุษไร้พลัง ไข่ต้ม,2022-06-17,5,10,0,10,75.71,0
A Pact With Me,2022-07-16,6,10,0,10,75.71,0
Lovers Anonymous Rehab for Romantics,2022-09-18,3,10,0,10,75.71,0
UNILOGUE,2022-10-22,7,10,0,10,75.71,1
Opaloid Kingdom,2022-11-22,3,10,0,10,75.71,0
Space Route,2022-08-26,3,10,0,10,75.71,0
Trigger Henry,2022-10-28,5,10,0,10,75.71,0
Hanaja's Body,2022-07-15,12,10,0,10,75.71,0
Crossfar,2022-07-28,5,10,0,10,75.71,0
Gronk Want Rock,2022-07-17,3,10,0,10,75.71,0
Sippin Hot Blickety Block N Bop Those Bad Battle Boys Down To Size Supreme,2022-08-30,4,10,0,10,75.71,0
Meow Defence,2022-10-21,2,10,0,10,75.71,0
Heroes of Hellas Origins: Part Two,2022-09-28,13,10,0,10,75.71,5
Odium,2022-10-21,2,10,0,10,75.71,0
LUMbA: REDUX,2022-08-04,3,10,0,10,75.71,0
Tiny Solar System,2022-10-19,3,10,0,10,75.71,0
Step Journey,2022-09-09,4,10,0,10,75.71,0
Stunts Contest Extreme Cars,2022-11-07,2,10,0,10,75.71,0
Samurai pussy,2022-09-23,2,10,0,10,75.71,0
Fix My Hand Doc,2022-10-26,2,10,0,10,75.71,0
Fury Turn,2022-10-11,4,10,0,10,75.71,0
Dark Moon Motel,2022-10-07,2,10,0,10,75.71,0
Motherboard Under Attack,2022-12-15,2,10,0,10,75.71,0
Puzzle: Triangles,2022-10-14,2,10,0,10,75.71,0
VR Solo Noble(Peg solitaire),2022-11-15,1,10,0,10,75.71,0
VR World of Pandas,2022-11-15,1,10,0,10,75.71,0
Across-Stitch,2022-11-23,6,10,0,10,75.71,0
VR Pterosaur,2022-12-02,1,10,0,10,75.71,0
VR Dinosaur Invasion,2022-12-02,1,10,0,10,75.71,0
Anime Hunter,2022-12-16,5,10,0,10,75.71,0
VR Dinosaur Hunter,2022-12-09,1,10,0,10,75.71,0
Forbidden Love with My Wife's Sister,2022-12-20,4,10,0,10,75.71,0
Soulstice,2022-09-20,599,771,200,971,75.7,17
SUKUR,2022-11-02,8,81,15,96,75.7,0
Line War,2022-05-05,306,460,114,574,75.69,11
方境战记BlockFight,2022-05-25,159,114,23,137,75.68,0
Furry Orgasm,2022-07-22,10,114,23,137,75.68,1
Furry Fantasy,2022-07-09,487,68,12,80,75.68,1
Jump The Gun,2022-11-25,25,68,12,80,75.68,0
Magical Girl Clicker,2022-10-06,71,68,12,80,75.68,9
MY LITTLE PONY: A Maretime Bay Adventure,2022-05-27,96,315,75,390,75.67,22
Anvil Saga,2022-06-21,804,662,170,832,75.66,16
Broken Edge,2022-11-17,34,138,29,167,75.66,0
Alan's Automaton Workshop,2022-01-20,134,134,28,162,75.66,0
Oaken,2022-05-03,143,134,28,162,75.66,0
Exoblast,2022-01-31,195,243,56,299,75.65,0
Nonno Lorenzo,2022-10-06,6,16,1,17,75.64,0
Operation Zeta,2022-01-14,3,16,1,17,75.64,0
Hearts of the Dungeon List,2022-04-29,7,16,1,17,75.64,0
Crooks Like Us,2022-04-06,12,16,1,17,75.64,0
Omegabot,2022-06-16,3,16,1,17,75.64,0
2089 - Space Divided,2022-09-16,9,16,1,17,75.64,1
Heart & Soul,2022-02-28,4,16,1,17,75.64,0
Indirection,2022-01-09,3,16,1,17,75.64,0
JENTRIX,2022-01-27,6,16,1,17,75.64,0
Tough Love Arena,2022-05-05,6,16,1,17,75.64,0
A Clockwork Ley-Line: Daybreak of Remnants Shadow,2022-03-18,18,16,1,17,75.64,2
Sperm Runner,2022-03-14,2,16,1,17,75.64,0
Sperm Runner,2022-03-14,2,16,1,17,75.64,0
Sperm Runner,2020-08-04,3,28,9,37,67.09,0
Sperm Runner,2020-08-04,3,28,9,37,67.09,0
Billy 101,2022-05-31,6,16,1,17,75.64,0
Crazy Cube Adventure,2022-02-08,2,16,1,17,75.64,0
Sharing Lights,2022-03-04,12,16,1,17,75.64,0
Project Medved,2022-05-25,6,16,1,17,75.64,0
Jewel Match Origins 2 - Bavarian Palace Collector's Edition,2022-04-21,20,16,1,17,75.64,9
Past Particles,2022-05-11,7,16,1,17,75.64,0
Z-Warp,2022-06-21,4,16,1,17,75.64,0
Alice in Wonderland Jigsaw Puzzle,2022-09-26,3,16,1,17,75.64,0
2MD:VR Football Unleashed All-Star,2022-09-20,10,16,1,17,75.64,0
Pretty Girls Tile Match,2022-09-30,5,16,1,17,75.64,0
The First Mountain,2022-10-05,2,16,1,17,75.64,0
Battle Cry of Freedom,2022-03-01,893,1423,387,1810,75.63,64
Riding to Bounce City,2022-09-15,98,208,47,255,75.62,5
Sail,2022-08-10,12,41,6,47,75.62,2
Hero King Quest: Peacemaker Prologue,2022-05-13,8,41,6,47,75.62,1
Krampus Kills,2022-12-02,56,41,6,47,75.62,0
The Way Home: Pixel Roguelike,2022-10-17,35,41,6,47,75.62,0
Dog Adventure,2022-01-18,3,50,8,58,75.6,0
Dog Adventure,2022-01-18,3,50,8,58,75.6,0
Dog Adventure,2021-12-30,3,16,0,16,78.69,0
Dog Adventure,2021-12-30,3,16,0,16,78.69,0
Where Are My Mittens,2022-04-08,8,50,8,58,75.6,0
BONELAB,2022-09-29,11991,8536,2519,11055,75.56,274
Deadly Night,2022-09-02,58,141,30,171,75.56,1
Maid Knight Alicia,2022-05-14,38,80,15,95,75.55,0
Synth Retro Vapor Wave,2022-09-13,3,36,5,41,75.53,0
攻城三国志,2022-04-29,13,36,5,41,75.53,5
Fried Panic,2022-09-28,13,36,5,41,75.53,0
Furry Meow,2022-11-04,8,36,5,41,75.53,0
Monuments Flipper: Prologue,2022-05-18,340,191,43,234,75.51,1
Redout 2,2022-06-16,412,623,161,784,75.5,22
The WILDS,2022-02-15,13,67,12,79,75.5,2
Paladin's Oath,2022-03-03,10,67,12,79,75.5,1
The Ramen Sensei,2022-09-05,95,54,9,63,75.5,11
オンライン線香花火,2022-06-24,158,45,7,52,75.48,0
Football Simulator,2022-06-09,61,198,45,243,75.46,5
Secret Series : BJ,2022-01-31,18,128,27,155,75.46,0
The Crackpet Show: Prologue,2022-12-02,699,128,27,155,75.46,2
Primal Survivors,2022-11-15,10,31,4,35,75.46,0
Kurokami-sama's Feast,2022-01-21,15,31,4,35,75.46,0
Polimines,2022-03-29,9,31,4,35,75.46,0
未知记录,2022-04-29,36,31,4,35,75.46,0
Windfolk: Sky is just the Beginning,2022-09-26,8,31,4,35,75.46,0
Good Night Peregrine,2022-10-27,3,31,4,35,75.46,0
Fairy Biography,2022-05-26,274,499,127,626,75.44,0
皇帝与社稷·测试版 The Emperor and State·Beta version,2022-06-02,432,299,72,371,75.44,6
Dead Containment,2022-10-21,9,21,2,23,75.44,0
Last Visit,2022-08-19,6,21,2,23,75.44,0
BeastCrimes,2022-01-08,111,21,2,23,75.44,0
NaGongGan,2022-08-12,6,21,2,23,75.44,0
Mythos: Sudoku,2022-10-17,14,21,2,23,75.44,0
D&D Stronghold: Kingdom Simulator,2022-03-29,21,21,2,23,75.44,2
Yum Collector,2022-03-02,3,21,2,23,75.44,0
Alchemia: Creatio Ex Nihilo,2022-07-28,25,21,2,23,75.44,0
Occult Rewrite,2022-06-24,5,21,2,23,75.44,1
Chonky - From Breakfast to Domination,2022-11-01,3,21,2,23,75.44,1
Matcha,2022-08-09,38,21,2,23,75.44,0
Slime Ranger,2022-11-15,3,21,2,23,75.44,0
Domino Simulator,2022-03-29,23,58,10,68,75.43,2
Bots Are Stupid,2022-12-15,53,58,10,68,75.43,2
For Goodness Sake,2022-12-05,9,58,10,68,75.43,0
Runaway Animals,2022-09-22,13,26,3,29,75.41,0
Virus At Home,2022-01-07,4,26,3,29,75.41,0
TENDY: Robot Gardener,2022-05-19,5,26,3,29,75.41,0
It's Hard Being A Dog,2022-05-02,7,26,3,29,75.41,0
The Call of Krul'ar,2022-06-08,25,26,3,29,75.41,0
SCP: Containment Breach Remastered,2022-08-04,89,454,115,569,75.38,36
Task Force,2022-08-27,229,327,80,407,75.38,0
Undergrave,2022-07-13,12,49,8,57,75.37,0
Pro Strategy Football 2023,2022-09-08,45,49,8,57,75.37,11
Life of a Space Force Captain,2022-05-05,71,40,6,46,75.36,0
山海皆可平,2022-08-19,3,40,6,46,75.36,0
Past Synergy,2022-04-04,12,40,6,46,75.36,0
Rolling in the Maze,2022-05-13,132,464,118,582,75.35,0
Kach,2022-08-18,14,162,36,198,75.35,0
Furry Striptease,2022-09-30,16,66,12,78,75.33,0
Itorah,2022-03-21,104,289,70,359,75.32,8
Dark Light,2022-09-29,96,398,100,498,75.31,6
Dark Light,2022-09-29,96,398,100,498,75.31,0
Dark Light,2021-10-01,5,5,1,6,64.78,6
Dark Light,2021-10-01,5,5,1,6,64.78,0
Cave Digger 2: Dig Harder,2022-09-08,20,70,13,83,75.29,2
Duloga,2022-01-22,6,53,9,62,75.29,0
Resist the succubus—The end of the female Knight,2022-07-22,2171,771,206,977,75.28,9
Deadly Premonition 2,2022-06-11,104,184,42,226,75.28,5
Source of Madness,2022-05-11,184,536,139,675,75.27,6
8/8/88 Needle AL,2022-05-09,7,78,15,93,75.24,1
Umbra galaxy,2022-02-14,11,35,5,40,75.24,0
Xeno Command,2022-11-09,24,35,5,40,75.24,0
Xmas Apocalypse,2022-12-15,14,35,5,40,75.24,0
Hellslave,2022-05-26,691,403,102,505,75.23,10
A World of Little Legends,2022-03-01,43,57,10,67,75.23,1
Lilith Odyssey,2022-11-05,13,44,7,51,75.23,0
Breakout: Recharged,2022-02-10,12,44,7,51,75.23,2
Age of Valakas: Vietnam,2022-05-13,7,44,7,51,75.23,0
The Fox's Drawing World,2022-02-06,16,44,7,51,75.23,0
PI.EXE,2022-03-07,14,44,7,51,75.23,0
Car Dealership Simulator,2022-09-20,536,889,241,1130,75.22,50
Kaiju Wars,2022-04-28,91,141,31,172,75.2,1
Moonscars,2022-09-27,347,459,118,577,75.19,6
Final Vendetta,2022-06-17,23,160,36,196,75.18,2
Cartel Tycoon,2022-07-26,2244,2059,589,2648,75.17,245
Hero's Journey,2022-07-14,697,865,235,1100,75.16,9
Hero's Journey,2022-07-14,697,865,235,1100,75.16,0
Hero's Journey,2022-07-14,697,865,235,1100,75.16,0
Hero's Journey,2022-09-21,2,4,0,4,69.2,9
Hero's Journey,2022-09-21,2,4,0,4,69.2,0
Hero's Journey,2022-09-21,2,4,0,4,69.2,0
Hero's Journey,2020-03-18,2,4,0,4,69.2,9
Hero's Journey,2020-03-18,2,4,0,4,69.2,0
Hero's Journey,2020-03-18,2,4,0,4,69.2,0
The Centennial Case: A Shijima Story,2022-05-12,873,528,138,666,75.14,5
Astronite,2022-11-30,28,65,12,77,75.14,0
Ashen Empires,2022-09-03,1271,208,49,257,75.12,188
Rabbit Hole,2022-09-10,21,144,32,176,75.12,0
Rabbit Hole,2022-09-10,21,144,32,176,75.12,0
Rabbit Hole,2021-09-01,3,2,1,3,55.69,0
Rabbit Hole,2021-09-01,3,2,1,3,55.69,0
Far Away From Home,2022-08-18,24,30,4,34,75.12,0
Arali,2022-08-13,4,30,4,34,75.12,0
Elf Sex Farm,2022-10-25,634,274,67,341,75.11,7
Skull's Impossible Quest,2022-01-16,3,15,1,16,75.1,0
Birb Café,2022-05-12,4,15,1,16,75.1,0
Help me please,2022-01-09,6,15,1,16,75.1,0
Slime Dice,2022-08-26,8,15,1,16,75.1,0
Box's Dream,2022-01-14,3,15,1,16,75.1,0
Bhop Craze,2022-08-29,8,15,1,16,75.1,0
BYLITSA: VASNA,2022-02-18,6,15,1,16,75.1,0
雛ちゃんのとっかえ！わらしべランチ,2022-01-11,8,15,1,16,75.1,0
Jigsaw Pink,2022-03-08,2,15,1,16,75.1,0
Battle of the Four Towers,2022-03-19,5,15,1,16,75.1,0
Paper Nebula,2022-10-20,4,15,1,16,75.1,0
Alexander the Great: Secrets of Power,2022-07-15,9,15,1,16,75.1,0
Bone Lover - Horror Escape,2022-09-12,4,15,1,16,75.1,0
Enclosure 3-D,2022-09-13,4,15,1,16,75.1,0
Shape Of The Toilet Rim,2022-09-20,3,15,1,16,75.1,0
Tower Numbers,2022-11-11,2,15,1,16,75.1,0
Tropical Hearts,2022-11-19,3,15,1,16,75.1,0
BLASTRONAUT,2022-07-27,126,105,22,127,75.09,1
Ampersat,2022-05-06,8,39,6,45,75.09,0
Sky in your eyes,2022-07-23,9,39,6,45,75.09,0
Helicopter Gunship DEX,2022-12-01,8,39,6,45,75.09,1
東方実在相 ～ Dream Logical World,2022-01-21,47,170,39,209,75.07,0
HENTAI: NAZI GIRL,2022-09-27,4,52,9,61,75.07,0
Weird West,2022-03-31,4621,1984,571,2555,75.05,33
The Matriarch,2022-09-26,490,423,109,532,75.05,0
Numina,2022-06-30,18,25,3,28,75.03,1
CAT & MOUSE,2022-09-04,18,25,3,28,75.03,0
Dungeon Looter,2022-10-14,9,25,3,28,75.03,0
CreepWars TD,2022-04-15,4,25,3,28,75.03,0
Baby Goat Billy,2022-04-29,4,25,3,28,75.03,0
Content,2022-02-04,3,25,3,28,75.03,0
Melania,2022-05-30,3,25,3,28,75.03,0
Something Strange,2022-05-31,3,25,3,28,75.03,0
Model Builder,2022-02-08,880,854,234,1088,75.02,10
Sex Chess,2022-11-10,324,513,135,648,75.01,6
Evil Reap,2022-04-15,4,9,0,9,75.0,0
Mongrel,2022-02-19,5,9,0,9,75.0,0
Birds with Feelings,2022-05-13,3,9,0,9,75.0,0
Faking to Dance,2022-05-18,1,9,0,9,75.0,0
Project Colonies: MARS 2120,2022-10-27,5,9,0,9,75.0,0
Neko Nyaa~,2022-03-22,2,9,0,9,75.0,0
The Sound of Fireworks: The Haiku,2022-06-24,2,9,0,9,75.0,0
Godbeast Mk.II,2022-11-23,3,9,0,9,75.0,0
JezzBall Atomic,2022-02-14,3,9,0,9,75.0,0
STERN,2022-03-15,3,9,0,9,75.0,0
Godspell Defender,2022-05-23,3,9,0,9,75.0,0
Gridform,2022-07-29,3,9,0,9,75.0,0
RD Mars,2022-01-19,1,9,0,9,75.0,0
ET Superman : Wrath of Tyrannosaurus Rex,2022-11-06,2,9,0,9,75.0,0
Clutter 12: It's About Time - Collector's Edition,2022-04-05,8,9,0,9,75.0,1
AgriLife,2022-04-14,4,9,0,9,75.0,0
Skew Pong,2022-02-10,3,9,0,9,75.0,0
Citrus Rampage,2022-04-20,4,9,0,9,75.0,0
Destructor Tanks ,2022-01-11,5,9,0,9,75.0,0
No Haste,2022-01-07,4,9,0,9,75.0,0
Satama Puzzle,2022-05-18,6,9,0,9,75.0,0
Imperial Arms: Curse of the Conqueror,2022-02-06,4,9,0,9,75.0,0
Nectar Wars,2022-07-26,4,9,0,9,75.0,0
SGS Glory Recalled,2022-02-10,5,9,0,9,75.0,0
Cramit's Keep,2022-01-10,4,9,0,9,75.0,0
Warsaw: Paris of the North,2022-01-26,3,9,0,9,75.0,0
Ms. Holmes: The Adventure of the McKirk Ritual Collector's Edition,2022-01-03,7,9,0,9,75.0,0
Bitcoin Chill,2022-02-04,3,9,0,9,75.0,0
Panicked and Surrounded by Hot Vampires,2022-02-08,3,9,0,9,75.0,0
Gaikokujin No Sensei (Foreigner Teacher),2022-06-20,7,9,0,9,75.0,0
Alien Space Bastards,2022-02-09,2,9,0,9,75.0,0
FACTOR D,2022-05-24,3,9,0,9,75.0,0
The Forked Road,2022-10-14,2,9,0,9,75.0,0
I Love Finding Critters,2022-04-11,5,9,0,9,75.0,0
Legend of Radiance,2022-03-04,3,9,0,9,75.0,0
Forget Westbury Falls: Disc One,2022-03-01,3,9,0,9,75.0,0
Dial-In,2022-07-16,4,9,0,9,75.0,0
SONOHIGURASHI VS. TOUHOU UNIVERSE,2022-03-25,3,9,0,9,75.0,0
Hit Him,2022-04-12,3,9,0,9,75.0,0
No Anglerfish,2022-04-05,4,9,0,9,75.0,0
hehe,2022-04-16,3,9,0,9,75.0,0
Dodge & Weave,2022-04-22,3,9,0,9,75.0,0
Ren's Demons I,2022-08-08,2,9,0,9,75.0,0
Kaiju,2022-06-03,4,9,0,9,75.0,0
Departure.,2022-06-06,4,9,0,9,75.0,0
Manglepaw,2022-05-10,2,9,0,9,75.0,0
Panique à Temple A-Steak,2022-10-04,3,9,0,9,75.0,0
Happy Hops,2022-05-14,3,9,0,9,75.0,0
Awakening of Legend,2022-10-31,6,9,0,9,75.0,0
Last Meow Standing,2022-12-15,4,9,0,9,75.0,0
Pylorus - Footsteps of Greed,2022-07-11,3,9,0,9,75.0,0
Panda Run,2022-06-03,3,9,0,9,75.0,0
Panda Run,2022-06-03,3,9,0,9,75.0,0
Panda Run,2017-08-31,8,78,44,122,60.66,0
Panda Run,2017-08-31,8,78,44,122,60.66,0
Yeah Jam Fury (2012),2022-07-06,6,9,0,9,75.0,0
BUBBLE NIGHT,2022-07-12,4,9,0,9,75.0,0
Charlie and Friends,2022-08-12,5,9,0,9,75.0,0
Beat Blitz,2022-10-24,2,9,0,9,75.0,0
Triennale Game Collection 2,2022-07-11,3,9,0,9,75.0,0
Omega Squad,2022-07-01,2,9,0,9,75.0,0
Once in Yaissor 3,2022-12-03,2,9,0,9,75.0,0
流星降临的小镇：来自过去的幽灵,2022-07-26,4,9,0,9,75.0,0
Finding Ice,2022-08-29,2,9,0,9,75.0,0
Junkyard Fury 2,2022-10-28,5,9,0,9,75.0,1
I commissioned some bees 6,2022-09-08,6,9,0,9,75.0,1
DON'T STOP YOU'LL DIE!,2022-08-12,4,9,0,9,75.0,0
Abstract Grind,2022-10-15,3,9,0,9,75.0,0
Night Flight,2022-08-20,2,9,0,9,75.0,0
Unreal Vendetta,2022-09-03,3,9,0,9,75.0,0
The Entity Code,2022-10-12,2,9,0,9,75.0,0
Dry School,2022-09-27,2,9,0,9,75.0,0
Love Spell: Aslan's Route,2022-11-02,13,9,0,9,75.0,0
Coffee For Robots,2022-09-29,3,9,0,9,75.0,0
NSG,2022-10-28,2,9,0,9,75.0,0
My Girlfriend is a Futanari,2022-11-11,3,9,0,9,75.0,0
PARADISE CLEANING - Married Woman Cosplay Life -,2022-12-30,3,9,0,9,75.0,0
Needy Dragons,2022-10-04,3,9,0,9,75.0,0
Lost Dream: Stars,2022-11-04,2,9,0,9,75.0,0
Lighten Up,2022-11-02,3,9,0,9,75.0,0
MY NEEDY NEIGHBOUR GIRLS,2022-11-02,5,9,0,9,75.0,0
Maruja Mallo,2022-11-15,2,9,0,9,75.0,0
Ruins of Istanbul,2022-11-23,2,9,0,9,75.0,0
Blocks Tracks Trains,2022-11-03,4,9,0,9,75.0,0
下山的试炼之江湖遗失录,2022-12-23,3,9,0,9,75.0,0
向往的方向,2022-12-21,2,9,0,9,75.0,0
Innocence Or Money - V 0.0.3,2022-05-20,120,250,61,311,74.99,14
Ricky Recharge,2022-12-20,3,20,2,22,74.99,0
Downslope,2022-01-20,7,20,2,22,74.99,0
Weapons Simulator,2022-02-27,4,20,2,22,74.99,0
YONESAWARA HOSPITAL,2022-08-19,22,20,2,22,74.99,0
WORDLAND - Let's Travel,2022-06-20,7,20,2,22,74.99,0
Still be a Human,2022-08-01,6,20,2,22,74.99,0
三国記II,2022-07-08,13,20,2,22,74.99,1
Furry Hentai Isekai,2022-05-11,5,20,2,22,74.99,0
Hellway,2022-10-27,5,20,2,22,74.99,0
Fly Tales,2022-08-19,2,20,2,22,74.99,0
Coins Collector Sport Car,2022-08-22,3,20,2,22,74.99,0
Dead Second,2022-10-15,5,20,2,22,74.99,0
Bravery and Greed,2022-11-15,786,343,87,430,74.97,20
Cursed to Golf,2022-08-18,341,300,75,375,74.97,0
Anuchard,2022-04-21,14,64,12,76,74.96,0
Spacelines From The Far Out,2022-06-09,172,231,56,287,74.94,4
CYBERHUNK,2022-09-24,12,68,13,81,74.94,0
Spearmint Goose,2022-04-01,2,34,5,39,74.93,0
TEMPLE of RUBBO,2022-03-10,7,34,5,39,74.93,0
Automaton Kingdom,2022-05-23,13,34,5,39,74.93,0
Wheels of Duty,2022-09-01,37,80,16,96,74.92,0
AI Roguelite,2022-03-02,46,168,39,207,74.91,9
Chemists: Area of infection,2022-09-09,5,47,8,55,74.9,0
Fantasy Fishing Town,2022-05-10,39,47,8,55,74.9,0
CRUMB,2022-11-18,98,219,53,272,74.88,13
烈山海贰,2022-01-05,30,51,9,60,74.85,0
懒人修仙传2,2022-06-21,1423,521,139,660,74.84,246
GetsuFumaDen: Undying Moon,2022-02-17,662,678,185,863,74.83,7
Beneath Oresa,2022-11-03,296,329,84,413,74.83,29
Eville,2022-10-11,948,265,66,331,74.82,6
Koncolos: Prologue,2022-03-04,5,38,6,44,74.8,0
Andromeda Survivors,2022-10-14,8,38,6,44,74.8,0
Dark Secrets of Showbiz,2022-05-10,57,87,18,105,74.79,0
Hero Realms,2022-06-06,120,159,37,196,74.78,39
Upload Simulator,2022-09-09,119,59,11,70,74.78,3
International Basketball Manager 23,2022-12-01,128,59,11,70,74.78,34
ICEwall,2022-10-14,30,29,4,33,74.78,1
Monster Girl Invasion RPG,2022-03-19,23,29,4,33,74.78,1
Tower of Ardia,2022-09-24,174,79,16,95,74.77,1
Voice of Cards: The Beasts of Burden,2022-09-13,92,63,12,75,74.77,4
FILF,2022-04-14,60,67,13,80,74.76,6
KINGDOM of the DEAD,2022-02-10,48,177,42,219,74.74,1
Scorn,2022-10-14,7949,7672,2375,10047,74.72,54
Eternal Evil,2022-11-01,75,302,77,379,74.72,0
The Scarlet Demonslayer,2022-12-10,363,173,41,214,74.72,3
Lords and Villeins,2022-11-10,349,403,106,509,74.71,39
Bartender Hustle,2022-05-27,43,98,21,119,74.7,2
Godsbane,2022-03-04,75,98,21,119,74.7,0
天命奇御：歸途 Fate Seeker: Journey,2022-12-12,3170,799,223,1022,74.68,10
Tower Princess: Knight's Trial,2022-06-23,370,208,51,259,74.63,0
Hipster Cafe,2022-04-29,12,24,3,27,74.63,1
NecroBoy : Path to Evilship,2022-10-31,5,24,3,27,74.63,0
Bauer,2022-03-31,5,24,3,27,74.63,0
SEARCH ALL - SUSHI,2022-02-04,3,24,3,27,74.63,0
DOOM TOMB,2022-03-23,6,24,3,27,74.63,0
Dungeons & Dragons: Ravenloft Series,2022-03-29,17,24,3,27,74.63,3
4 Seasons Girls,2022-07-07,3,24,3,27,74.63,0
Assassin Girls,2022-07-15,3,24,3,27,74.63,0
Milf Toys 2,2022-04-08,3,24,3,27,74.63,0
Observo,2022-10-21,4,24,3,27,74.63,1
Sexual Summer,2022-12-09,12,24,3,27,74.63,1
Open The Gates!,2022-10-17,46,50,9,59,74.62,0
Pain Party,2022-08-22,22,50,9,59,74.62,0
～Daydream～蝶が舞う頃に,2022-05-26,25,105,23,128,74.61,2
Yakyosho,2022-05-27,5,33,5,38,74.61,0
Hyper Gunsport,2022-12-22,7,33,5,38,74.61,0
Mystery of Mortlake Mansion,2022-07-08,14,33,5,38,74.61,6
秦殇,2022-01-11,1860,1542,451,1993,74.59,9
Furry Sex: Poker 🃏♥️,2022-08-13,40,74,15,89,74.59,1
Junkyard Truck,2022-07-27,390,468,126,594,74.58,44
王牌对决,2022-07-28,256,427,114,541,74.58,7
Road Defense: Outsiders,2022-09-23,17,58,11,69,74.58,0
Qwilight,2022-06-11,48,93,20,113,74.54,2
Limb Hunter,2022-03-04,3,14,1,15,74.53,0
Bloody Paws Unleashed,2022-10-14,2,14,1,15,74.53,0
Ad Wars,2022-05-20,4,14,1,15,74.53,1
Boney's Research On Humans !,2022-08-24,2,14,1,15,74.53,0
Failed Ninja Academy,2022-06-01,2,14,1,15,74.53,0
流光記憶之灰 Grayscale Memories,2022-07-19,4,14,1,15,74.53,0
Mango Mischief,2022-06-20,5,14,1,15,74.53,2
Cool Animals,2022-06-21,3,14,1,15,74.53,0
Seal of Evil,2022-01-27,4,14,1,15,74.53,0
Terranova,2022-04-28,4,14,1,15,74.53,0
Days with Ophelia: The Girl From Wind City,2022-03-24,3,14,1,15,74.53,0
Alien Extraction,2022-03-28,5,14,1,15,74.53,0
かつて私たちは地獄のまっただ中でした。,2022-01-20,18,14,1,15,74.53,0
SKAZKA,2022-01-20,6,14,1,15,74.53,0
Tokyo Onmyoji -The Tale of Rei Tengenjibashi-,2022-03-17,13,14,1,15,74.53,0
Dawn of Kagura: Keika's Story,2022-01-08,5,14,1,15,74.53,0
File Under Kingdom,2022-01-18,11,14,1,15,74.53,0
Morph King,2022-08-26,2,14,1,15,74.53,0
Light of Life,2022-11-14,3,14,1,15,74.53,0
SlingStar,2022-01-28,3,14,1,15,74.53,0
Robert: Space Stories and Battles,2022-03-08,3,14,1,15,74.53,0
Covid Carl,2022-10-25,2,14,1,15,74.53,0
Sweet Car Wash,2022-08-21,3,14,1,15,74.53,0
StudioS Fighters: Climax Champions,2022-06-17,6,14,1,15,74.53,0
Tobor Party,2022-04-24,8,14,1,15,74.53,0
Square Keeper,2022-06-09,3,14,1,15,74.53,0
Industrial Trouble,2022-05-08,2,14,1,15,74.53,0
Moi Mei: Hidden Objects,2022-05-18,2,14,1,15,74.53,1
Green Diver,2022-06-20,3,14,1,15,74.53,0
Jettatura,2022-10-16,10,14,1,15,74.53,0
TAXINAUT,2022-09-15,8,14,1,15,74.53,1
Cats Yakuza - Online card game,2022-07-30,6,14,1,15,74.53,0
All Hallows Evie,2022-10-06,3,14,1,15,74.53,0
Noblesse Oblige,2022-08-25,28,14,1,15,74.53,0
Superhero Girls,2022-08-24,2,14,1,15,74.53,0
Ean's End,2022-09-21,5,14,1,15,74.53,0
Demolish or Die,2022-11-10,6,14,1,15,74.53,0
Me With Me,2022-11-03,3,14,1,15,74.53,0
Two Skateboards Driving Simulator,2022-12-08,2,14,1,15,74.53,0
Kalzoon,2022-11-23,2,14,1,15,74.53,0
Golem Builder,2022-12-20,7,14,1,15,74.53,0
WHAT THE BAT?,2022-11-17,9,37,6,43,74.51,0
Sex Toys,2022-12-02,9,37,6,43,74.51,0
Zerograve,2022-05-16,3,19,2,21,74.51,0
Draco Knight,2022-04-25,3,19,2,21,74.51,0
夢游仙境ロマネスク: Chronicles of Refugia,2022-08-27,20,19,2,21,74.51,0
Legendary Tales: Сataclysm,2022-01-03,18,19,2,21,74.51,1
BounceShot,2022-05-10,5,19,2,21,74.51,0
Magitek VR,2022-10-11,4,19,2,21,74.51,0
Catnight,2022-03-07,7,19,2,21,74.51,0
Funtasia,2022-09-29,12,19,2,21,74.51,0
THE GAME,2022-02-25,2,19,2,21,74.51,0
The Duck Is In Danger,2022-01-11,3,19,2,21,74.51,0
Phonetic,2022-02-25,4,19,2,21,74.51,0
ALAN-13 Reformation,2022-05-11,17,19,2,21,74.51,0
The Quintessential Quintuplets OMOIDE VR ~ITSUKI~,2022-10-13,14,19,2,21,74.51,0
无神塔,2022-05-13,3,19,2,21,74.51,0
Neko Girls,2022-08-25,3,19,2,21,74.51,0
CyberHeroes Arena,2022-09-27,4,19,2,21,74.51,0
Jigsaw Puzzle Best Places,2022-12-16,11,19,2,21,74.51,1
Sker Ritual,2022-10-06,237,401,107,508,74.5,7
EBOLA 3,2022-09-18,60,199,49,248,74.5,0
RUINSMAGUS,2022-07-07,56,119,27,146,74.49,0
Fargone,2022-12-23,54,104,23,127,74.49,3
Omega Pilot,2022-09-02,9,77,16,93,74.44,0
Mythicard,2022-11-06,23,41,7,48,74.44,0
Acolyte,2022-06-28,15,41,7,48,74.44,0
171,2022-11-17,1266,1861,556,2417,74.41,72
Bail or Jail,2022-07-21,72,133,31,164,74.41,1
Cute BAR,2022-01-06,4,28,4,32,74.41,0
Dadish 3,2022-06-14,7,28,4,32,74.41,0
The Tale of Onogoro,2022-09-28,10,28,4,32,74.41,0
Hi Eggplant!,2022-09-16,5,28,4,32,74.41,0
Villain's Legacy,2022-12-13,82,69,14,83,74.4,3
Flock of Dogs,2022-11-30,24,61,12,73,74.38,5
Race Condition,2022-03-01,7,61,12,73,74.38,1
Goo Gladiators,2022-09-22,25,61,12,73,74.38,0
Car Detailing Simulator,2022-04-13,1165,455,124,579,74.37,42
IFO,2022-05-19,14,53,10,63,74.37,1
Outnumbered,2022-09-09,54,125,29,154,74.34,6
Extremely Realistic Siege Warfare Simulator,2022-09-08,103,84,18,102,74.34,1
Soundfall,2022-05-11,665,679,192,871,74.31,3
Cyphers Game,2022-04-21,61,362,97,459,74.31,0
Trash Patrol - Academic Version,2022-05-17,53,80,17,97,74.31,9
Perseus: Titan Slayer - Free Trial,2022-11-16,1366,543,151,694,74.3,0
Tracery of Fate,2022-07-29,10,95,21,116,74.29,0
Mirror Forge,2022-12-06,38,95,21,116,74.29,0
The Doll's Window,2022-09-20,10,32,5,37,74.28,0
Baldur's Gate: Dark Alliance II,2022-07-20,638,327,87,414,74.26,25
Like an Angel,2022-02-11,312,171,42,213,74.26,0
Stranded Deep,2022-08-11,6036,30084,9874,39958,74.25,714
Amazing Frog ? V3,2022-06-16,67,234,60,294,74.25,16
风色旅人,2022-11-18,247,461,127,588,74.24,12
Ascend- Reborn,2022-12-01,563,444,122,566,74.23,14
Technicity,2022-09-15,103,113,26,139,74.22,15
Legend of Kendor,2022-12-02,28,23,3,26,74.2,0
My Master's A Moron,2022-06-02,10,23,3,26,74.2,0
Medusa's Heart of Stone Chapter 01,2022-03-15,4,23,3,26,74.2,0
Cyclone,2022-06-23,4,23,3,26,74.2,0
Visionarium 2 - The Descent,2022-06-20,4,23,3,26,74.2,0
Extinction Eclipse,2022-11-17,4,23,3,26,74.2,0
Airport Administrator Simulator,2022-05-14,2,23,3,26,74.2,0
Quest Together,2022-12-24,15,64,13,77,74.19,2
Tim-Tim 2,2022-05-09,2,8,0,8,74.19,0
Effigy,2022-05-12,2,8,0,8,74.19,0
Cock Soccer,2022-02-03,3,8,0,8,74.19,0
Maggie the Magnet,2022-07-18,4,8,0,8,74.19,0
Bounty,2022-06-16,5,8,0,8,74.19,0
Bounty,2022-06-16,5,8,0,8,74.19,0
Bounty,2022-12-02,3,9,3,12,63.45,0
Bounty,2022-12-02,3,9,3,12,63.45,0
RainyCloud,2022-11-11,2,8,0,8,74.19,0
Smash Crates,2022-06-06,4,8,0,8,74.19,0
CAN ANDROIDS SURVIVE,2022-06-28,3,8,0,8,74.19,0
We Are Live,2022-05-02,4,8,0,8,74.19,0
Mezzanine,2022-10-07,4,8,0,8,74.19,0
Cycled,2022-07-11,10,8,0,8,74.19,0
A Mirror Puzzle,2022-07-15,2,8,0,8,74.19,0
System Under Surveillance,2022-02-25,3,8,0,8,74.19,0
Cepheus Protocol Anthology Season 1,2022-05-12,5,8,0,8,74.19,0
Strange Investigations: Becoming Collector's Edition,2022-06-17,15,8,0,8,74.19,2
History of Football World Cup,2022-05-12,2,8,0,8,74.19,0
Whispers of Ancient Stone,2022-03-18,4,8,0,8,74.19,0
Sword of Elpisia,2022-01-07,20,8,0,8,74.19,1
Gem Rifts,2022-01-28,3,8,0,8,74.19,0
Elemgate,2022-07-08,1,8,0,8,74.19,0
HatMania,2022-11-15,3,8,0,8,74.19,0
Love Accident,2022-01-07,2,8,0,8,74.19,0
Galactic Racing Online,2022-03-08,4,8,0,8,74.19,0
Rambell,2022-12-15,6,8,0,8,74.19,0
月光のソードブレイカー ミナト編,2022-01-25,2,8,0,8,74.19,0
Super Perils of Baking,2022-06-03,5,8,0,8,74.19,0
Running on Empty,2022-09-10,4,8,0,8,74.19,0
Athemore,2022-04-10,2,8,0,8,74.19,0
Square Knight,2022-04-30,3,8,0,8,74.19,0
Polar Bear Riding A Ninja,2022-06-01,2,8,0,8,74.19,0
TumbleWeed,2022-05-13,3,8,0,8,74.19,0
Mindfulness Simulator - ASMR Meditation Game,2022-06-21,3,8,0,8,74.19,0
Space MOLMAE,2022-06-05,3,8,0,8,74.19,0
The Detroit After,2022-12-16,2,8,0,8,74.19,0
Sheep's Territory,2022-03-29,3,8,0,8,74.19,0
Vayan,2022-11-30,9,8,0,8,74.19,0
[Speer DX],2022-06-03,4,8,0,8,74.19,0
Rocket Mania,2022-06-18,3,8,0,8,74.19,0
Chaos Law,2022-04-19,3,8,0,8,74.19,0
Ukko & Guará: Stellarbound,2022-09-29,3,8,0,8,74.19,0
Four Course Dungeon,2022-05-27,5,8,0,8,74.19,0
Lenny Loosejocks in Space,2022-11-01,5,8,0,8,74.19,0
Eternal Samurai,2022-05-31,2,8,0,8,74.19,0
BEWBEWBEW,2022-06-12,4,8,0,8,74.19,0
EpicRecovery,2022-06-15,4,8,0,8,74.19,0
Otaku Engine,2022-12-01,5,8,0,8,74.19,0
Plop Saga,2022-06-29,2,8,0,8,74.19,0
LEEN,2022-06-17,10,8,0,8,74.19,0
Immortelle,2022-11-15,2,8,0,8,74.19,0
Wreck the Fed,2022-06-24,2,8,0,8,74.19,0
Midnight Zone,2022-08-04,2,8,0,8,74.19,0
Radii,2022-07-29,5,8,0,8,74.19,0
Space Monkeys,2022-07-16,3,8,0,8,74.19,0
The Empanada Protocol,2022-07-29,4,8,0,8,74.19,0
Chicken Fall Prologue,2022-07-22,88,8,0,8,74.19,0
Jelly In The Dark,2022-12-21,3,8,0,8,74.19,0
NYYO,2022-07-27,3,8,0,8,74.19,0
GirlPuzzle,2022-08-25,3,8,0,8,74.19,0
Gummy Jump,2022-08-02,3,8,0,8,74.19,0
European Football Dynasty 23,2022-09-22,7,8,0,8,74.19,0
Super Casual Ultimate Fight Fest (Extra Deluxe),2022-09-09,7,8,0,8,74.19,0
Hidden in the Dark,2022-08-05,2,8,0,8,74.19,0
Tiles II - Multiplayer,2022-08-12,7,8,0,8,74.19,0
Drunk: Relapsed,2022-11-04,4,8,0,8,74.19,0
Super Ball Mania,2022-08-15,5,8,0,8,74.19,0
Synthalaxy,2022-09-10,3,8,0,8,74.19,0
Flowers of Satsunai,2022-11-18,5,8,0,8,74.19,0
CAPTROON,2022-08-23,2,8,0,8,74.19,0
Interquel幕間折,2022-08-26,1,8,0,8,74.19,0
Cosmotica,2022-09-02,3,8,0,8,74.19,0
锻灵ElementForger,2022-09-22,3,8,0,8,74.19,0
Dungeon in a Bottle,2022-10-24,5,8,0,8,74.19,0
Ceaseless Night,2022-12-01,5,8,0,8,74.19,0
Quarterstaff,2022-12-27,4,8,0,8,74.19,0
Super Anime Waifu BBQ Simulator,2022-09-22,2,8,0,8,74.19,0
New Yankee: Karma Tales,2022-12-28,36,8,0,8,74.19,5
Input Chaos,2022-09-20,4,8,0,8,74.19,0
Cage of Etha,2022-09-19,2,8,0,8,74.19,0
A Smooth Game (Unlike... Life) ,2022-10-04,2,8,0,8,74.19,0
流離之歌,2022-11-16,4,8,0,8,74.19,0
Ballspell,2022-10-04,4,8,0,8,74.19,0
I commissioned some bees 7,2022-09-30,8,8,0,8,74.19,0
PHYAKH,2022-10-18,7,8,0,8,74.19,0
Running into the Cyberpunk,2022-10-03,2,8,0,8,74.19,0
SEARCH ALL - KEYS,2022-10-04,2,8,0,8,74.19,0
Lost Amulets: Mystic Land,2022-10-03,5,8,0,8,74.19,0
Quiz.com,2022-10-11,7,8,0,8,74.19,0
Boo!,2022-10-17,6,8,0,8,74.19,0
Step By Step Hero,2022-10-24,2,8,0,8,74.19,0
Rift Rangers,2022-12-08,12,8,0,8,74.19,0
I commissioned some bees 10,2022-11-17,6,8,0,8,74.19,1
BOT.vinnik Chess: Prodigies,2022-10-27,2,8,0,8,74.19,0
Theocracy,2022-11-25,4,8,0,8,74.19,0
HellRazor64,2022-11-17,3,8,0,8,74.19,0
Orbit,2022-12-07,5,8,0,8,74.19,0
Surrealidade - Definitive Edition,2022-12-08,2,8,0,8,74.19,0
One Wheel Guy,2022-11-30,19,8,0,8,74.19,0
抵御者 Defender,2022-12-02,2,8,0,8,74.19,0
WHERE IS A TOILET!?,2022-12-12,2,8,0,8,74.19,0
Blacklight,2022-12-29,8,8,0,8,74.19,0
Kaichu - A Kaiju Dating Sim,2022-09-07,31,60,12,72,74.17,3
The Last Queen in the Wizard Kingdom,2022-03-24,26,40,7,47,74.16,0
MY WOLF - Desktop Wild Pet,2022-06-11,83,152,37,189,74.15,5
Again and Again,2022-09-15,8,56,11,67,74.15,0
Escape First Alchemist: Prologue,2022-11-11,9,56,11,67,74.15,0
Tactics Ogre: Reborn,2022-11-11,10677,1913,582,2495,74.14,422
Ikai,2022-03-29,75,159,39,198,74.14,0
Obsidian Prince,2022-05-24,108,105,24,129,74.14,2
Sea Horizon,2022-10-20,83,105,24,129,74.14,5
风色幻想4:圣战的终焉,2022-08-09,56,44,8,52,74.14,3
In Woods,2022-11-23,35,44,8,52,74.14,0
MEGA,2022-09-02,8,44,8,52,74.14,0
Serious Sam: Tormental,2022-04-08,47,162,40,202,74.1,2
Deadwater Saloon Prologue,2022-08-04,111,112,26,138,74.1,0
SPACE ACCIDENT,2022-02-10,378,101,23,124,74.1,0
Out of Ore,2022-10-31,314,340,92,432,74.09,65
天仙月,2022-07-13,112,137,33,170,74.08,9
雪之本境S,2022-04-29,84,346,94,440,74.06,0
Among Us VR,2022-11-10,1144,1541,467,2008,74.03,32
European Air War,2022-06-16,6,27,4,31,74.03,1
Lulu's Temple,2022-04-14,5,27,4,31,74.03,0
Mouse People,2022-09-15,5,27,4,31,74.03,0
Fly Fly Tuk Tuk,2022-08-08,3,27,4,31,74.03,0
Asian Cargo Sim,2022-11-04,3,27,4,31,74.03,1
Cantata,2022-05-12,62,63,13,76,74.0,0
Aladdin : Save The Princess,2022-02-23,4,18,2,20,74.0,0
Cato the cat,2022-01-21,5,18,2,20,74.0,0
My Cute Girls,2022-01-06,3,18,2,20,74.0,0
GwenBlade,2022-02-07,2,18,2,20,74.0,0
Doki Doki House,2022-12-01,9,18,2,20,74.0,3
King Rabbit - Race,2022-06-22,10,18,2,20,74.0,0
Wet Cute Girls,2022-07-22,3,18,2,20,74.0,0
Molecule Make lab,2022-05-13,5,18,2,20,74.0,0
Blocks of Nature,2022-09-26,9,18,2,20,74.0,0
Super Geisha Neon,2022-12-07,4,18,2,20,74.0,0
cheesequest,2022-08-16,5,18,2,20,74.0,0
Mythic Frost Trials,2022-09-08,7,18,2,20,74.0,0
Degen Royale,2022-11-03,42,18,2,20,74.0,3
The Legend Of Tiger And Phoenix,2022-11-04,3,18,2,20,74.0,0
xdding,2022-12-23,3,18,2,20,74.0,0
My Grandparents Christmas Mystery,2022-12-30,3,18,2,20,74.0,0
Maurice: In The Predator's Nest,2022-12-05,221,503,142,645,73.99,16
WW2: Bunker Simulator ,2022-10-10,92,199,51,250,73.99,10
Serafina and the Key to the Egg,2022-06-25,169,78,17,95,73.98,3
Black One Blood Brothers,2022-01-11,89,407,113,520,73.97,3
Builder Simulator,2022-06-09,1571,850,250,1100,73.96,53
PearPhone.io,2022-06-17,23,59,12,71,73.96,0
Arcadius,2022-02-17,317,576,165,741,73.94,22
Arcadius,2022-02-17,317,576,165,741,73.94,0
Arcadius,2021-07-21,3,4,0,4,69.2,22
Arcadius,2021-07-21,3,4,0,4,69.2,0
Destroy All Humans! 2 - Reprobed,2022-08-30,2870,1297,392,1689,73.93,44
Lords of Solgrund,2022-02-21,9,31,5,36,73.93,0
Adventure of Leek,2022-02-24,7,31,5,36,73.93,0
Legend of Edda Brasil,2022-12-26,25,31,5,36,73.93,12
Lazy Galaxy 2,2022-03-15,444,114,27,141,73.91,7
AQtion,2022-06-01,104,242,64,306,73.9,12
SudoKube,2022-05-23,20,35,6,41,73.89,1
Oppai Puzzle L,2022-07-21,5,35,6,41,73.89,0
Sector Sweep,2022-11-03,12,13,1,14,73.89,0
Strawhart,2022-03-11,7,13,1,14,73.89,1
Rotatex 3,2022-12-09,2,13,1,14,73.89,0
Programmer Dungeon,2022-09-22,5,13,1,14,73.89,0
Nikola Tesla: War of the Currents,2022-05-12,17,13,1,14,73.89,0
GearHead Caramel,2022-07-22,4,13,1,14,73.89,0
Hyper-5,2022-01-28,4,13,1,14,73.89,0
Soul Light,2022-08-19,3,13,1,14,73.89,0
PAPER BIRDS,2022-02-20,3,13,1,14,73.89,0
Die A.I.,2022-12-05,3,13,1,14,73.89,0
Starship Wars,2022-01-18,2,13,1,14,73.89,0
Rise Of Enigmas,2022-02-08,4,13,1,14,73.89,0
隐刺,2022-01-19,6,13,1,14,73.89,0
CYBERSTELLAR,2022-04-08,2,13,1,14,73.89,0
whale.,2022-02-27,4,13,1,14,73.89,0
The Bad Son,2022-10-26,2,13,1,14,73.89,0
Iku Iku Succubus,2022-07-19,5,13,1,14,73.89,0
The Dark Realm,2022-03-22,6,13,1,14,73.89,0
Haunted Hotel: The Thirteenth Collector's Edition,2022-03-14,10,13,1,14,73.89,1
Light Bringer,2022-09-23,4,13,1,14,73.89,0
Island of Aito,2022-05-09,4,13,1,14,73.89,0
BYTE CATS,2022-10-19,3,13,1,14,73.89,0
Stack by stack,2022-06-20,2,13,1,14,73.89,0
不思議の大冒険 チルノ見参!,2022-12-26,29,13,1,14,73.89,2
Rhythm Stones,2022-10-25,9,13,1,14,73.89,0
Primordial Pain,2022-10-31,5,13,1,14,73.89,0
Chinese Characters,2022-11-30,4,13,1,14,73.89,0
Dwarfer,2022-11-21,2,13,1,14,73.89,0
Interplayer,2022-11-25,8,13,1,14,73.89,0
Don't Steal My Christmas!,2022-12-21,7,13,1,14,73.89,0
Stones Keeper: King Aurelius,2022-07-14,163,128,31,159,73.88,1
Backrooms: Escape Together,2022-10-18,248,975,291,1266,73.87,44
Retro Commander,2022-05-11,58,92,21,113,73.87,1
Hello Puppets: Midnight Show,2022-10-19,36,43,8,51,73.87,1
Rendezvous: Shadows of the Past,2022-05-26,9,43,8,51,73.87,0
Who's Who?,2022-08-29,560,275,74,349,73.86,6
Wayward Harbor,2022-02-25,14,81,18,99,73.86,0
Eva: Final Mission,2022-09-30,51,81,18,99,73.86,0
American Theft 80s,2022-06-15,773,479,136,615,73.85,18
Yi Xian: The Cultivation Card Game,2022-12-07,10818,2164,675,2839,73.83,257
Monark,2022-02-22,177,124,30,154,73.83,2
Sweet Transit,2022-07-28,1210,507,145,652,73.82,71
ELEX II,2022-03-01,8233,3640,1161,4801,73.81,367
Ring of Titans,2022-02-28,430,294,80,374,73.81,0
MergeCrafter,2022-08-23,307,307,84,391,73.79,192
Ultimate Fishing Simulator 2,2022-08-22,924,787,233,1020,73.78,43
Vade Retro : Exorcist,2022-10-28,834,653,191,844,73.77,17
Aquaculture Land,2022-12-22,14,134,33,167,73.77,1
Drone Wars,2022-03-11,53,84,19,103,73.76,0
The Fantasy World of Mahjong Princess,2022-05-12,133,84,19,103,73.76,0
AZUR BEAM,2022-04-01,21,102,24,126,73.75,0
20b,2022-02-09,5,58,12,70,73.75,0
Space Crusaders,2022-08-18,7,22,3,25,73.75,0
Chaos Chain,2022-01-28,3,22,3,25,73.75,0
Sigil of the Magi,2022-10-20,15,22,3,25,73.75,0
阿龙与地下城,2022-03-04,3,22,3,25,73.75,0
Final Space - The Rescue,2022-02-02,5,22,3,25,73.75,0
Vamps For The Memories,2022-03-10,7,22,3,25,73.75,1
Purgatory Dungeoneer,2022-10-06,9,22,3,25,73.75,0
Mini Mecum,2022-05-02,3,22,3,25,73.75,0
Hentai CyberGirl,2022-12-19,5,22,3,25,73.75,0
Burg,2022-07-10,259,661,194,855,73.73,15
Avani,2022-11-19,15,175,45,220,73.73,1
Axis Football 2023,2022-09-07,77,175,45,220,73.73,15
RitualSummon,2022-05-18,36,109,26,135,73.73,0
No More Money,2022-12-27,564,348,97,445,73.71,51
Spirit Hunters: Infinite Horde,2022-05-25,1816,905,273,1178,73.63,68
Nelson and the Magic Cauldron: The Journey,2022-01-28,4,26,4,30,73.63,0
Tiny Football,2022-11-15,11,26,4,30,73.63,1
Dungeons & Dragons: Dark Sun Series,2022-03-29,31,26,4,30,73.63,9
Elevator Action™ -Returns- S-Tribute,2022-11-30,10,26,4,30,73.63,0
枝江小镇,2022-07-14,6,26,4,30,73.63,0
F*ckable Kim,2022-09-05,3,26,4,30,73.63,0
No men in this house,2022-11-05,3,26,4,30,73.63,0
Wheel Of Naughtiness,2022-11-20,5,26,4,30,73.63,0
WitchCraft TD,2022-10-02,5,26,4,30,73.63,0
PumPum,2022-03-04,434,488,141,629,73.62,13
Neodori Forever,2022-06-15,13,46,9,55,73.62,1
Zombie Arena,2022-10-15,15,46,9,55,73.62,6
Knights of Honor II: Sovereign,2022-12-06,6061,2212,701,2913,73.59,613
Fap Goddess,2022-12-15,229,280,77,357,73.59,93
会计模拟器,2022-11-22,123,61,13,74,73.59,0
Anime Studio Story,2022-08-08,25,42,8,50,73.59,1
Cult Of Babel : Prologue,2022-08-15,46,42,8,50,73.59,0
STALCRAFT,2022-12-09,9097,11603,3879,15482,73.58,"4,317"
Hitler Loves Anime,2022-01-20,5,72,16,88,73.58,0
The Atlas Mystery: A VR Puzzle Game,2022-04-13,8,38,7,45,73.57,0
史小坑花前月下,2022-12-29,26,38,7,45,73.57,1
Trapped In Stone,2022-03-02,3,30,5,35,73.57,0
Shapebreaker - Tower Defense Deckbuilder,2022-07-19,17,30,5,35,73.57,0
Moth Lake,2022-12-03,13,30,5,35,73.57,0
轻语谱,2022-07-01,10,34,6,40,73.56,0
Five Nights at Sexy's,2022-07-15,3,34,6,40,73.56,0
Forgive My SIns & Desires Father,2022-10-22,9,34,6,40,73.56,2
Party Pie,2022-08-27,17,57,12,69,73.53,0
Golden Light of Rose,2022-10-24,676,186,49,235,73.52,1
Imp of the Sun,2022-03-24,20,68,15,83,73.52,1
Floor is Water,2022-03-18,17,86,20,106,73.51,0
Steelrising,2022-09-08,2804,2092,665,2757,73.5,67
Evil West,2022-11-21,4594,3773,1229,5002,73.47,111
AmongUs Challenger,2022-12-21,18,64,14,78,73.45,0
Acretia - Guardians of Lian,2022-10-14,31,64,14,78,73.45,0
Fingerbang: All Bullets Pointin',2022-12-09,15,64,14,78,73.45,0
Cosmic collapse,2022-02-10,2,17,2,19,73.45,0
Forever Someday,2022-12-31,2,17,2,19,73.45,0
RESEARCH and DESTROY,2022-04-25,10,17,2,19,73.45,0
Last Gang Standing,2022-10-24,6,17,2,19,73.45,0
Red Wings: American Aces,2022-03-31,17,17,2,19,73.45,0
巫女契约,2022-10-07,4,17,2,19,73.45,0
Everdine - A Lost Girl's Tale,2022-11-18,5,17,2,19,73.45,0
Melodier,2022-03-18,6,17,2,19,73.45,0
Cat Swap Tiles,2022-01-19,3,17,2,19,73.45,0
Kokoro Clover Season1,2022-08-03,10,17,2,19,73.45,0
From Heaven To Earth,2022-02-18,7,17,2,19,73.45,0
Glamor & Girls,2022-02-17,3,17,2,19,73.45,0
My Lovely Girls,2022-01-19,3,17,2,19,73.45,0
Samurai of Hyuga Book 5,2022-09-01,68,17,2,19,73.45,1
Snips & Snails,2022-02-01,5,17,2,19,73.45,0
Ghost Castle,2022-02-23,7,17,2,19,73.45,0
Mark's Magnificent Marble Maze,2022-08-02,6,17,2,19,73.45,0
Natal Perdido,2022-04-21,3,17,2,19,73.45,0
Pretty Girls Escape,2022-06-03,5,17,2,19,73.45,0
Revenge of the Orcs: Flag of Conquest,2022-08-12,6,17,2,19,73.45,0
The Futanati,2022-09-01,4,17,2,19,73.45,0
The Wire Man,2022-07-21,6,17,2,19,73.45,0
Witch Amelia,2022-10-21,7,17,2,19,73.45,0
Easy Simple Game,2022-09-08,6,17,2,19,73.45,0
FunnyPizzaLand,2022-10-08,2,17,2,19,73.45,0
Fury of West,2022-10-14,3,17,2,19,73.45,0
The Bogtavern,2022-12-30,3,17,2,19,73.45,0
World of Haiku,2022-07-22,48,82,19,101,73.44,4
Total War: WARHAMMER III,2022-02-17,166754,49835,17268,67103,73.41,"67,214"
晴末置雨,2022-07-21,51,221,60,281,73.41,0
 Симулятор Прыгания по Гаражам ,2022-12-23,60,452,132,584,73.37,1
Recipe for Disaster,2022-08-05,307,436,127,563,73.37,2
Cafe Owner Simulator: Prologue,2022-06-21,359,458,134,592,73.36,60
MeiQi 2022,2022-09-06,24,85,20,105,73.35,0
MotoGP™22,2022-04-21,673,676,204,880,73.34,96
Fray Fight,2022-06-10,620,495,146,641,73.33,12
Broken Pieces,2022-09-09,171,200,54,254,73.32,6
Downtown Jam,2022-07-11,14,56,12,68,73.31,1
Click To Sail,2022-09-29,9,41,8,49,73.3,0
Food Girls - Bubbles' Drink Stand,2022-07-19,15,102,25,127,73.28,0
Lonesome Village,2022-11-01,66,88,21,109,73.27,4
DARK MINUTE: Kira's Adventure,2022-01-20,3,21,3,24,73.27,0
Barton Lynch Pro Surfing,2022-04-07,9,21,3,24,73.27,2
FRAGROOM: Defenders,2022-02-03,12,21,3,24,73.27,0
Parasite,2022-03-25,7,21,3,24,73.27,0
Parasite,2022-03-25,7,21,3,24,73.27,0
Parasite,2022-03-25,7,21,3,24,73.27,0
Parasite,2022-03-19,2,2,0,2,64.08,0
Parasite,2022-03-19,2,2,0,2,64.08,0
Parasite,2022-03-19,2,2,0,2,64.08,0
Parasite,2016-01-19,4,4,3,7,53.32,0
Parasite,2016-01-19,4,4,3,7,53.32,0
Parasite,2016-01-19,4,4,3,7,53.32,0
Be,2022-08-01,5,21,3,24,73.27,0
Locked in my darkness,2022-12-09,4,21,3,24,73.27,0
Paranormal Observation,2022-10-25,8,21,3,24,73.27,1
The Black Knight,2022-12-07,3,21,3,24,73.27,0
The Black Knight,2022-12-07,3,21,3,24,73.27,0
The Black Knight,2018-12-19,1,1,0,1,59.42,0
The Black Knight,2018-12-19,1,1,0,1,59.42,0
Musical Range,2022-06-07,2,7,0,7,73.26,0
Moonbase Down,2022-02-22,2,7,0,7,73.26,0
Rotund Rebound,2022-04-01,3,7,0,7,73.26,0
Rencia,2022-02-14,2,7,0,7,73.26,0
Monster Breakout,2022-08-16,2,7,0,7,73.26,0
GameLab UngAalborg,2022-09-08,4,7,0,7,73.26,0
The Hero with a Thousand Arms,2022-12-27,2,7,0,7,73.26,0
Time Patrol,2022-02-10,3,7,0,7,73.26,0
Super Marxist Twins,2022-03-25,3,7,0,7,73.26,0
Fillit,2022-06-02,4,7,0,7,73.26,0
Tales From The Cache,2022-03-06,3,7,0,7,73.26,0
Aquillanto,2022-10-13,1,7,0,7,73.26,0
Nilspace,2022-12-05,5,7,0,7,73.26,0
Purry Furry Adventurry,2022-02-08,2,7,0,7,73.26,0
Coldage,2022-07-01,2,7,0,7,73.26,0
On The Earth Shift :),2022-02-21,2,7,0,7,73.26,0
Dodge Dots,2022-02-02,18,7,0,7,73.26,0
Happy Bones Infernal,2022-03-14,4,7,0,7,73.26,0
Alec Adventure,2022-10-27,2,7,0,7,73.26,0
Jumphobia: Homeward Bound,2022-04-06,5,7,0,7,73.26,0
Boris the Sloth,2022-03-04,2,7,0,7,73.26,0
UfoTofU Hex,2022-01-21,3,7,0,7,73.26,0
Last Space Guardian,2022-02-12,2,7,0,7,73.26,0
Blackjack Avenue,2022-06-21,2,7,0,7,73.26,0
Tear of Time: Lost memory,2022-03-01,4,7,0,7,73.26,0
ONE WAY,2022-02-18,2,7,0,7,73.26,0
NEW TERRA,2022-05-06,1,7,0,7,73.26,0
G-MODEアーカイブス+ 弾幕検定死験-大往生編-,2022-01-20,6,7,0,7,73.26,0
How to Take Off Your Mask Remastered,2022-03-04,3,7,0,7,73.26,0
Let's Cook,2022-01-10,5,7,0,7,73.26,0
BOK,2022-01-14,3,7,0,7,73.26,0
Groove Fit Island!!,2022-06-14,4,7,0,7,73.26,0
Trigger Dungeon,2022-01-18,2,7,0,7,73.26,0
Axiallis,2022-01-20,2,7,0,7,73.26,0
Novalie,2022-03-19,2,7,0,7,73.26,0
Hell Mission,2022-01-31,1,7,0,7,73.26,0
Relics 2: The Crusader's Tomb,2022-04-08,8,7,0,7,73.26,0
Avatar Raiders,2022-02-25,7,7,0,7,73.26,1
Path to Ruin,2022-10-07,2,7,0,7,73.26,0
A2 Zygon,2022-12-01,3,7,0,7,73.26,0
Ink'n'Think,2022-03-11,2,7,0,7,73.26,0
Robot-X,2022-11-25,2,7,0,7,73.26,0
Little Ninja,2022-04-15,2,7,0,7,73.26,0
M-1グランプリへの道　～俺たちの出囃子はもう鳴っている～,2022-03-24,8,7,0,7,73.26,0
The Breadmaker,2022-06-06,2,7,0,7,73.26,0
Horse and Go Seek,2022-04-21,2,7,0,7,73.26,0
SOOT,2022-05-27,3,7,0,7,73.26,0
JellyMen,2022-04-23,4,7,0,7,73.26,0
Entomophobia,2022-04-16,3,7,0,7,73.26,0
PLASMATIC,2022-06-22,5,7,0,7,73.26,0
Epic Vampire,2022-04-07,2,7,0,7,73.26,0
polyemisokos,2022-06-23,3,7,0,7,73.26,0
Recreation Room,2022-06-21,2,7,0,7,73.26,0
Magic Tower (Destroy the Wormhole),2022-04-26,3,7,0,7,73.26,0
Mini Island: Cosmos,2022-07-01,3,7,0,7,73.26,0
Bunny Hop : Eggstreme,2022-11-10,5,7,0,7,73.26,0
Plank Road,2022-12-09,3,7,0,7,73.26,0
Jacks or Better - Video Poker,2022-04-28,3,7,0,7,73.26,1
AISZplus,2022-06-11,4,7,0,7,73.26,0
Meteor Blasters,2022-04-29,4,7,0,7,73.26,0
The Struggle of Combat,2022-05-06,2,7,0,7,73.26,0
Some Synergy,2022-08-05,8,7,0,7,73.26,0
Ukraine Defender,2022-05-12,1,7,0,7,73.26,0
The Liminal,2022-05-10,2,7,0,7,73.26,0
The Finally รักเราชั่วนิรันดร์,2022-05-18,2,7,0,7,73.26,0
SANONTA - Finnish Proverb Game,2022-12-06,3,7,0,7,73.26,0
Space Aces,2022-07-02,2,7,0,7,73.26,0
Pentomino,2022-05-31,4,7,0,7,73.26,0
Eat Fish Get Achievements,2022-10-09,5,7,0,7,73.26,0
God Edge,2022-05-31,3,7,0,7,73.26,0
Mida's Adventure,2022-06-06,1,7,0,7,73.26,0
Snacky Tower,2022-09-13,3,7,0,7,73.26,0
AI UNDER TEST,2022-06-13,2,7,0,7,73.26,0
Pizza Death,2022-07-09,3,7,0,7,73.26,0
180 SECONDS,2022-09-10,2,7,0,7,73.26,0
Shadow of Asha,2022-06-09,4,7,0,7,73.26,0
Retrowave Rider,2022-10-18,2,7,0,7,73.26,0
曦Lost Girl,2022-07-14,3,7,0,7,73.26,0
Nightly Maintenance,2022-06-28,2,7,0,7,73.26,0
A Game with a Kitty 1 & 2,2022-06-28,3,7,0,7,73.26,0
Limited Lifetime Corp,2022-08-12,4,7,0,7,73.26,0
Kokoro's Gensokyo Journey: The Lost Masks,2022-07-02,2,7,0,7,73.26,0
Bomb Dolls,2022-07-13,3,7,0,7,73.26,0
One Week By Car,2022-07-22,3,7,0,7,73.26,0
ROGUELINE,2022-08-05,5,7,0,7,73.26,0
Protocol Xeno,2022-08-13,4,7,0,7,73.26,0
Spectre Of Eternity,2022-08-04,2,7,0,7,73.26,0
Myth of Mirka,2022-07-28,2,7,0,7,73.26,0
Furry Android Hentai,2022-08-01,4,7,0,7,73.26,0
The Dancer - Definitive Edition,2022-08-01,2,7,0,7,73.26,0
SONOHIGURASHI VS. TOUHOU UNIVERSE2,2022-08-25,3,7,0,7,73.26,0
An Opportunity,2022-09-09,4,7,0,7,73.26,0
minschima,2022-09-07,2,7,0,7,73.26,0
The Top,2022-09-02,3,7,0,7,73.26,0
Roll On Dice,2022-09-12,3,7,0,7,73.26,0
Dodge,2022-08-14,3,7,0,7,73.26,0
Dodge,2022-08-14,3,7,0,7,73.26,0
Dodge,2022-08-14,3,7,0,7,73.26,0
Dodge,2022-08-14,3,7,0,7,73.26,0
Dodge,2021-06-29,2,5,3,8,56.05,0
Dodge,2021-06-29,2,5,3,8,56.05,0
Dodge,2021-06-29,2,5,3,8,56.05,0
Dodge,2021-06-29,2,5,3,8,56.05,0
Dodge,2018-01-09,4,28,12,40,63.46,0
Dodge,2018-01-09,4,28,12,40,63.46,0
Dodge,2018-01-09,4,28,12,40,63.46,0
Dodge,2018-01-09,4,28,12,40,63.46,0
Dodge,2015-03-16,98,58,17,75,69.91,0
Dodge,2015-03-16,98,58,17,75,69.91,0
Dodge,2015-03-16,98,58,17,75,69.91,0
Dodge,2015-03-16,98,58,17,75,69.91,0
DreamCell: Lost in Nightmares,2022-11-25,3,7,0,7,73.26,0
Lovelust: Project Stockholm,2022-09-16,6,7,0,7,73.26,0
Ice Nosfe,2022-12-21,1,7,0,7,73.26,0
Elves Christmas Hentai Puzzle,2022-12-16,4,7,0,7,73.26,0
Detective tales: A Study in Scarlet,2022-10-31,4,7,0,7,73.26,0
Crescent Cauldron Cafe,2022-09-12,3,7,0,7,73.26,0
Survive The Troll,2022-10-05,7,7,0,7,73.26,0
Lofi Waifu Jigsaw,2022-09-16,3,7,0,7,73.26,0
Saga Cube,2022-12-17,3,7,0,7,73.26,0
末日竟在我身边3 - Zombies Everywhere 3,2022-10-01,4,7,0,7,73.26,0
Clutter's Greatest Hits - Collector's Edition,2022-12-07,11,7,0,7,73.26,1
Space Cheetah Hyper Runner,2022-10-31,2,7,0,7,73.26,0
Robot Programmer,2022-12-06,4,7,0,7,73.26,0
Blessed Work,2022-12-20,5,7,0,7,73.26,0
キミもvtuberにならないか？,2022-10-31,3,7,0,7,73.26,0
Many Minigames,2022-11-22,2,7,0,7,73.26,0
SEARCH ALL - BUDS,2022-11-08,2,7,0,7,73.26,0
Metal March,2022-12-02,3,7,0,7,73.26,0
Arenamania,2022-12-10,2,7,0,7,73.26,0
Shanubis,2022-10-31,1040,7,0,7,73.26,0
Lie of Caelum,2022-12-12,6,7,0,7,73.26,0
Princess Cage,2022-12-02,3,7,0,7,73.26,0
Stray Cat Doors2,2022-12-19,3,7,0,7,73.26,0
Project Survivor,2022-12-13,4,7,0,7,73.26,0
Bavovna included!,2022-11-19,3,7,0,7,73.26,0
Space Moonshiner,2022-12-07,3,7,0,7,73.26,0
Dungeon: Faster & Deadlier,2022-12-13,23,37,7,44,73.25,2
原点计划：序章,2022-12-02,117,37,7,44,73.25,0
Age of Undead,2022-07-26,14,52,11,63,73.24,3
MILF Conditioning,2022-12-06,192,139,36,175,73.22,2
彷徨之街 The Street of Adrift,2022-09-01,1109,1158,364,1522,73.21,4
Equinoxe,2022-02-18,7,33,6,39,73.21,0
JAM GODS,2022-07-18,10,33,6,39,73.21,0
Village of Zombies,2022-05-06,7,33,6,39,73.21,0
Desktop Mars,2022-07-30,18,33,6,39,73.21,3
War of Wizards,2022-09-21,12,33,6,39,73.21,3
Home Run High,2022-10-11,109,33,6,39,73.21,29
Labyrinth: The War on Terror,2022-10-21,66,98,24,122,73.2,4
Ephemeral Tale,2022-01-18,7,25,4,29,73.2,0
MetaCard：The Turing Test,2022-09-23,6,25,4,29,73.2,0
Colors! Maze 2,2022-03-16,4,25,4,29,73.2,0
Ody Mos,2022-07-14,7,25,4,29,73.2,0
Hanako in the abandoned school,2022-06-30,14,25,4,29,73.2,0
Quriocity,2022-10-14,10,25,4,29,73.2,1
异世界的回响千雪之歌,2022-08-18,7,25,4,29,73.2,0
Void Scrappers Prologue,2022-09-06,21,25,4,29,73.2,0
Pumpkin Ripper,2022-12-16,5,25,4,29,73.2,0
From The Rain,2022-12-20,4,25,4,29,73.2,1
Runic,2022-09-30,111,132,34,166,73.19,1
Attack of the Giant Crab,2022-01-28,17,29,5,34,73.19,0
看谁先死,2022-03-01,4,29,5,34,73.19,0
Wild Castle,2022-11-04,11,12,1,13,73.19,0
The Dark Heart of Balor,2022-08-04,4,12,1,13,73.19,0
RavenWeald,2022-09-08,5,12,1,13,73.19,0
Russian Prison Tattoo Simulator,2022-04-15,2,12,1,13,73.19,0
God of Riffs,2022-09-21,4,12,1,13,73.19,0
Hex of the Lich,2022-07-29,8,12,1,13,73.19,0
Crystal Plague,2022-08-30,3,12,1,13,73.19,0
Burning Horns: A Bara Isekai JRPG,2022-03-04,5,12,1,13,73.19,0
Relash,2022-03-29,6,12,1,13,73.19,0
Lost but Lucid,2022-09-16,3,12,1,13,73.19,0
Archery Land,2022-09-02,4,12,1,13,73.19,0
Mysteria of the World: The forest of Death,2022-02-19,4,12,1,13,73.19,0
Tor-tor cubes,2022-01-19,2,12,1,13,73.19,0
The Sinking Structure Clione and Lost Child,2022-02-16,3,12,1,13,73.19,0
Yoko Redux: Dreams,2022-07-29,2,12,1,13,73.19,0
树莓战记,2022-02-14,4,12,1,13,73.19,0
Dere-chat,2022-05-05,2,12,1,13,73.19,0
Sahara's Underworld,2022-05-02,2,12,1,13,73.19,0
SECOND WORLD,2022-03-08,4,12,1,13,73.19,0
Mad Murder's Mystery Pie Shop,2022-04-11,2,12,1,13,73.19,0
Pizza Synthwave,2022-05-03,3,12,1,13,73.19,0
Vitality Girl Ⅲ:Pixel,2022-03-24,2,12,1,13,73.19,0
Delusions of a Lost Soul,2022-08-30,2,12,1,13,73.19,0
Burrow of the Fallen Bear: A Gay Furry Visual Novel,2022-08-05,8,12,1,13,73.19,0
Memory Shards,2022-05-20,2,12,1,13,73.19,0
Gem Setter,2022-05-19,4,12,1,13,73.19,0
ROTA,2022-05-26,4,12,1,13,73.19,0
来人 LIGHTWORKERS,2022-08-08,3,12,1,13,73.19,0
Incoherence,2022-06-30,7,12,1,13,73.19,0
Sexy Sharks,2022-06-21,3,12,1,13,73.19,0
Shogunaria,2022-10-03,5,12,1,13,73.19,0
Light Kin,2022-10-05,3,12,1,13,73.19,0
Colorless World,2022-08-30,4,12,1,13,73.19,0
Golden Rails: World’s Fair,2022-08-24,24,12,1,13,73.19,8
The Silent Huntress,2022-10-31,4,12,1,13,73.19,0
ギャルアンドチェーンソー～GirlAndChainsaw～,2022-10-01,8,12,1,13,73.19,0
Viking Heroes 3,2022-11-16,23,12,1,13,73.19,4
Magnus Positive Phototaxis,2022-11-30,5,12,1,13,73.19,0
Masterchef Cakes Edition,2022-10-29,2,12,1,13,73.19,0
Stickman's Arena,2022-11-14,3,12,1,13,73.19,0
The Sentient Box,2022-12-22,7,12,1,13,73.19,0
Mystic Forest,2022-11-24,3,12,1,13,73.19,0
Cult of the Mask,2022-11-21,2,12,1,13,73.19,0
Dungeon of Death,2022-12-02,5,12,1,13,73.19,0
Myasoid,2022-11-19,2,12,1,13,73.19,0
Medusa,2022-11-29,3,12,1,13,73.19,0
Fears of Glasses o-o World War,2022-12-22,2,12,1,13,73.19,0
College Kings 2 - Episode 1,2022-04-14,2372,898,279,1177,73.17,165
Hentai Lagoon,2022-05-19,13,48,10,58,73.16,0
Solargene,2022-01-31,253,313,90,403,73.12,21
Bus World,2022-09-29,66,233,65,298,73.12,5
Chenso Club,2022-09-01,49,138,36,174,73.12,5
Occult,2022-05-19,256,1170,371,1541,73.08,19
Uninvited,2022-05-25,6,44,9,53,73.08,0
Eyes in the Dark,2022-07-14,49,90,22,112,73.04,3
MiniGolf Maker,2022-02-25,15,62,14,76,73.04,3
Element-174,2022-01-03,86,76,18,94,73.02,7
The Long Road North,2022-04-28,9,69,16,85,73.02,0
별에게 소원을 (When you wish upon a star),2022-05-06,32,40,8,48,73.0,0
The Pinball Wizard,2022-10-27,18,40,8,48,73.0,0
Hentai CatMaid,2022-11-06,6,40,8,48,73.0,0
Smart Factory Tycoon: Beginnings,2022-01-05,417,357,105,462,72.97,3
Dungeons of Sundaria,2022-07-18,330,554,169,723,72.96,37
Loopmancer,2022-07-13,525,400,119,519,72.95,1
Green Hell VR,2022-06-09,236,532,162,694,72.94,27
幻想三国志2,2022-01-09,129,133,35,168,72.94,5
迷霧國度: 傳承 Myth of Mist：Legacy,2022-01-28,44,79,19,98,72.94,1
Big Bia,2022-06-10,1840,984,312,1296,72.93,0
BLINK: The Last Night,2022-01-03,14,65,15,80,72.93,0
Slime Girl Smoothies,2022-08-29,16,36,7,43,72.93,0
Alice!,2022-01-05,14,36,7,43,72.93,0
Erebe,2022-11-06,28,36,7,43,72.93,0
Defend The Bits,2022-06-16,36,36,7,43,72.93,1
Slava Ukraini!,2022-05-24,199,916,290,1206,72.89,4
The Oregon Trail,2022-11-14,470,342,101,443,72.86,52
Price of Power,2022-01-21,62,82,20,102,72.86,3
Hard Times at Sequoia State Park,2022-04-25,101,82,20,102,72.86,2
The Shadow Government Simulator,2022-10-17,29,32,6,38,72.86,4
Cursed Exped,2022-07-10,11,32,6,38,72.86,0
Perseverance Part: 2,2022-03-17,3,16,2,18,72.86,0
Grammarian Ltd,2022-04-20,6,16,2,18,72.86,0
The Niflhel Day,2022-02-12,8,16,2,18,72.86,0
ARMS DOLL,2022-09-30,7,16,2,18,72.86,0
Luna: Supernatural Hunter,2022-02-22,3,16,2,18,72.86,0
BALLYGON,2022-05-18,6,16,2,18,72.86,0
An Uninvited Guest,2022-07-12,5,16,2,18,72.86,1
Wild Adventures,2022-03-25,8,16,2,18,72.86,0
Drifting Kings,2022-09-01,3,16,2,18,72.86,0
Rogue Door Defense,2022-08-16,9,16,2,18,72.86,0
Blacken Slash: Prologue,2022-06-10,5,16,2,18,72.86,0
Babysitter Simulator,2022-06-25,3,16,2,18,72.86,0
Aero Striker - World Invasion,2022-10-19,8,16,2,18,72.86,0
Chess Dungeons,2022-07-25,5,16,2,18,72.86,0
The Van Game,2022-10-24,4,16,2,18,72.86,0
Jotunn,2022-10-27,4,16,2,18,72.86,0
RealFlight Evolution,2022-10-27,344,145,39,184,72.82,310
Ancient,2022-02-04,30,43,9,52,72.8,0
BiblioMania,2022-06-20,12,43,9,52,72.8,1
Block Breaker,2022-04-16,5,28,5,33,72.79,0
Extreme Truck Stunts,2022-10-21,5,28,5,33,72.79,0
My Lovely Wife,2022-06-08,862,374,112,486,72.77,3
Psychoscopy,2022-07-25,18,20,3,23,72.76,0
Diptych,2022-02-18,2,20,3,23,72.76,0
Square,2022-03-26,3,20,3,23,72.76,0
illumizzle: Finding the lost light,2022-04-17,5,20,3,23,72.76,0
Escape From Meat City,2022-09-07,4,20,3,23,72.76,0
Metal Flame,2022-08-04,26,20,3,23,72.76,0
Froggy's Farm & Friends,2022-08-06,3,20,3,23,72.76,0
Hentai Neko,2022-11-03,3,20,3,23,72.76,0
TOD Fragments: Special Fun,2022-12-01,5,20,3,23,72.76,0
Sperma,2022-12-15,5,20,3,23,72.76,0
Duelyst II,2022-12-17,1978,1024,329,1353,72.75,92
Frog Fight,2022-02-05,6,24,4,28,72.75,0
Suspect Enemy,2022-01-15,31,24,4,28,72.75,0
Skiing VR,2022-03-02,4,24,4,28,72.75,0
Desolation Tycoon,2022-01-14,23,24,4,28,72.75,0
One Step After Fall,2022-03-15,5,24,4,28,72.75,0
March to a Million,2022-10-31,30,24,4,28,72.75,7
Liminus: The Silent Guard,2022-11-17,6,24,4,28,72.75,0
Deneb: Across the Stars,2022-09-13,7,24,4,28,72.75,0
Language Lab,2022-07-09,7,24,4,28,72.75,0
DarkenDerek The last Fallen,2022-10-21,4,24,4,28,72.75,0
Wolfskin's Curse,2022-10-18,3,24,4,28,72.75,0
Lost Eidolons,2022-10-13,1489,798,253,1051,72.74,72
Justice.exe,2022-07-22,24,71,17,88,72.74,0
Resist,2022-12-09,17,39,8,47,72.7,0
X-Plane 12,2022-12-17,489,935,300,1235,72.69,352
NOX TIMORE REMAKE,2022-09-28,18,81,20,101,72.69,0
航海霸业,2022-09-28,122,101,26,127,72.67,14
Life is Strange Remastered,2022-02-01,1227,1409,463,1872,72.65,100
Nope Nope Nurses,2022-01-26,129,251,73,324,72.65,0
Hot And Lovely 5,2022-08-05,65,140,38,178,72.64,4
Nemesis: Lockdown,2022-11-17,381,331,99,430,72.63,21
My Pleasure - Season 1,2022-12-15,176,84,21,105,72.63,9
World of Warplanes,2022-02-10,688,2726,923,3649,72.61,131
Hero Roy's Wedding,2022-12-29,37,53,12,65,72.6,3
Into the Sinkhole,2022-09-17,14,77,19,96,72.59,0
Vincemus - Air Combat,2022-04-01,7,35,7,42,72.59,2
Blue Oak Bridge,2022-11-30,21,35,7,42,72.59,6
Monster,2022-09-02,177,149,41,190,72.57,1
Furry Sex: Pirates 🏴‍☠️,2022-09-03,475,70,17,87,72.55,0
Westwood Shadows,2022-07-15,20,42,9,51,72.51,0
Dungeoneers,2022-11-15,36,42,9,51,72.51,0
Routine Feat / Бытовой подвиг,2022-05-11,10,42,9,51,72.51,1
雨夜屠夫,2022-11-01,62,49,11,60,72.48,0
Spidersaurs,2022-07-14,9,31,6,37,72.48,0
Rapture - The Beginning,2022-01-21,12,31,6,37,72.48,0
万界之门,2022-03-08,76,73,18,91,72.47,0
Rogue Frontiers,2022-12-23,5,11,1,12,72.42,0
Kowloon High-School Chronicle: ORIGIN OF ADVENTURE,2022-11-10,35,11,1,12,72.42,2
To Your Stations!,2022-07-01,6,11,1,12,72.42,0
Puzzle Battler! Mirai,2022-04-21,7,11,1,12,72.42,0
Somber,2022-10-12,4,11,1,12,72.42,0
Mysteries Of Darkness,2022-01-31,7,11,1,12,72.42,0
CESSPOOL,2022-10-28,4,11,1,12,72.42,0
Isles of Cubes,2022-06-15,4,11,1,12,72.42,0
Slime Crown,2022-01-17,2,11,1,12,72.42,0
Au-Delà,2022-02-28,4,11,1,12,72.42,0
Grid Leaper,2022-07-13,3,11,1,12,72.42,0
Dandy & Randy DX,2022-04-29,4,11,1,12,72.42,0
The Callisto,2022-07-07,4,11,1,12,72.42,0
I deserve a happy ending,2022-06-30,7,11,1,12,72.42,0
Project SNAQE,2022-02-04,2,11,1,12,72.42,0
WHATEVER,2022-10-20,6,11,1,12,72.42,0
Warlordocracy,2022-07-17,4,11,1,12,72.42,0
边缘项目 / Living Island Project,2022-04-08,5,11,1,12,72.42,0
Astral Flux,2022-10-28,3,11,1,12,72.42,1
STIX: Combat Devolved,2022-02-07,7,11,1,12,72.42,0
Edessa: School of Wizardry,2022-07-27,2,11,1,12,72.42,0
如果还有明天,2022-01-14,5,11,1,12,72.42,0
Blood Island,2022-02-10,3,11,1,12,72.42,0
Blood Island,2022-02-10,3,11,1,12,72.42,0
Blood Island,2019-01-23,2,4,8,12,41.03,0
Blood Island,2019-01-23,2,4,8,12,41.03,0
Freeze the time,2022-01-19,2,11,1,12,72.42,0
Generic RPG Idle,2022-07-11,24,11,1,12,72.42,5
Life of Pepe,2022-04-13,3,11,1,12,72.42,0
ChestMate,2022-04-08,2,11,1,12,72.42,0
Miami Sunset Drive,2022-03-02,4,11,1,12,72.42,0
烈山海前传之黑帝君临,2022-08-03,5,11,1,12,72.42,0
Burial Stone,2022-06-30,2,11,1,12,72.42,0
VR HENTAI PLAY,2022-03-08,2,11,1,12,72.42,0
Championship Wrestling Promoter,2022-11-09,8,11,1,12,72.42,1
Lucky Villager,2022-04-09,5,11,1,12,72.42,0
REPULSOR,2022-05-19,3,11,1,12,72.42,0
Local Paper Small Town,2022-05-18,2,11,1,12,72.42,0
Horse Club Adventures 2: Hazelwood Stories,2022-10-27,23,11,1,12,72.42,0
The Hand of Glory - The Blowtorch Files,2022-05-09,6,11,1,12,72.42,0
Simulacrum,2022-07-05,4,11,1,12,72.42,0
Decorporation,2022-08-24,6,11,1,12,72.42,0
Logica Emotica,2022-06-07,10,11,1,12,72.42,0
MYRNEscapes,2022-05-18,3,11,1,12,72.42,0
MAGITERRA,2022-08-25,4,11,1,12,72.42,0
Jelly Forest,2022-05-26,5,11,1,12,72.42,0
Crash Forts,2022-05-26,5,11,1,12,72.42,0
impossiBot,2022-11-10,2,11,1,12,72.42,0
Puzzles with nature,2022-06-09,3,11,1,12,72.42,0
cookies СOOkies COOKIES,2022-06-30,2,11,1,12,72.42,0
TOTEMS 2,2022-07-02,5,11,1,12,72.42,0
Tower Defender VR: Last Adventure,2022-07-08,3,11,1,12,72.42,0
Fortitude invasion,2022-07-20,5,11,1,12,72.42,0
Asteroids,2022-07-17,3,11,1,12,72.42,1
69 Berta Hot,2022-07-26,3,11,1,12,72.42,0
Never ends acT,2022-07-17,4,11,1,12,72.42,0
MAGNET EFFECT,2022-12-27,4,11,1,12,72.42,0
rotatePDF: A Corporate Tale,2022-11-01,4,11,1,12,72.42,0
Fix My Cat Doc,2022-09-19,2,11,1,12,72.42,0
Mistress vs Slave,2022-09-29,12,11,1,12,72.42,0
Orcen Axe,2022-11-15,3,11,1,12,72.42,0
Two Cars Stunts Edition,2022-11-01,2,11,1,12,72.42,0
Secret Agent 001,2022-12-02,2,11,1,12,72.42,0
Stellar Echoes,2022-12-28,3,11,1,12,72.42,0
Crazy City Driving,2022-12-13,3,11,1,12,72.42,0
Family Business,2022-12-28,3,11,1,12,72.42,0
POSTAL 4: No Regerts,2022-04-20,916,7015,2477,9492,72.39,68
Toziuha Night: Dracula's Revenge,2022-03-21,8,27,5,32,72.38,0
Into The Dark,2022-04-21,7,27,5,32,72.38,0
Beautiful Mystic Survivors: Prologue,2022-09-28,594,169,48,217,72.37,0
FURRY HITLER,2022-05-28,411,469,147,616,72.36,0
Hindsight,2022-08-04,12,52,12,64,72.36,0
Dwarven Skykeep,2022-12-01,73,69,17,86,72.35,1
The Nightmare Catcher,2022-04-24,16,45,10,55,72.35,0
Made in Abyss: Binary Star Falling into Darkness,2022-09-02,2052,831,271,1102,72.32,27
Hentai Big Tits,2022-06-03,12,124,34,158,72.29,0
Quake Champions,2022-08-18,17476,26649,9723,36372,72.28,678
My Therapist is a Futanari,2022-01-21,8,95,25,120,72.28,0
Vacancy Unlimited,2022-04-06,4,23,4,27,72.28,0
GunsBox VR,2022-02-01,6,23,4,27,72.28,0
Lillian Night: Exclusive Contract of Succubus,2022-12-16,5,23,4,27,72.28,0
Space Dragons,2022-02-25,5,23,4,27,72.28,0
Frequency Dissonance,2022-05-19,4,23,4,27,72.28,0
Night Racer,2022-05-23,4,23,4,27,72.28,0
Comrade Quack,2022-04-12,3,23,4,27,72.28,0
Office Elevator,2022-04-02,3,23,4,27,72.28,0
My Stepmom is a Futanari Chemist,2022-09-08,6,23,4,27,72.28,1
Shinonome,2022-11-11,14,23,4,27,72.28,1
The siege of Brimir,2022-10-27,6,23,4,27,72.28,0
DO NOT OPEN,2022-11-30,10,23,4,27,72.28,0
Lustful Ponies 2,2022-09-01,6,23,4,27,72.28,0
Way of the Hunter,2022-08-16,9880,3822,1336,5158,72.26,582
Fly Dangerous,2022-05-24,100,205,60,265,72.26,0
Time on Frog Island,2022-07-12,94,111,30,141,72.26,0
Covid Simulator,2022-01-25,49,55,13,68,72.25,0
Fire Dogs,2022-10-18,5,34,7,41,72.24,0
Void's Calling ep. 2,2022-10-14,104,189,55,244,72.22,1
NeverSynth,2022-09-15,9,65,16,81,72.22,0
Jennifer Wilde: Unlikely Revolutionaries,2022-10-18,6,15,2,17,72.22,0
BIAS,2022-10-28,5,15,2,17,72.22,0
Arctictopia,2022-08-09,6,15,2,17,72.22,0
Mari and Bayu - The Road Home,2022-07-19,7,15,2,17,72.22,1
Super Squidlit,2022-02-09,3,15,2,17,72.22,0
From Red to Green,2022-01-03,3,15,2,17,72.22,0
HelloWorld:ESCAPE,2022-02-17,2,15,2,17,72.22,0
Dawn of Kagura: Hatsuka's Story,2022-01-08,4,15,2,17,72.22,0
Dawn of Kagura: Natsu's Story,2022-01-08,4,15,2,17,72.22,0
Psychic,2022-01-17,11,15,2,17,72.22,0
I don't think I've walked this stretch of road before,2022-01-31,2,15,2,17,72.22,0
Pixel Artist,2022-03-09,5,15,2,17,72.22,0
Card Craft,2022-09-06,4,15,2,17,72.22,0
Jewel Match Solitaire X Collector's Edition,2022-05-31,18,15,2,17,72.22,6
Super Arkanoid,2022-05-31,4,15,2,17,72.22,0
Sir Stretchalot - The Plight of the Elves,2022-09-15,10,15,2,17,72.22,0
Just Sign!,2022-08-26,7,15,2,17,72.22,0
Zombie Apocalypse - The Last Defense,2022-07-29,4,15,2,17,72.22,0
Neon Circle,2022-08-10,2,15,2,17,72.22,0
Southern Princesses,2022-08-24,2,15,2,17,72.22,0
Umbra,2022-12-20,3,15,2,17,72.22,0
Fishton: A Town to Remember,2022-09-29,6,15,2,17,72.22,0
KungFu Kickball,2022-02-10,20,48,11,59,72.21,0
IKO 39,2022-08-15,4,19,3,22,72.21,0
Karm,2022-03-17,5,19,3,22,72.21,0
Racing Outlaws,2022-01-24,6,19,3,22,72.21,0
Faylinn's Quest,2022-05-17,24,19,3,22,72.21,0
Live Waifu Wallpaper,2022-07-22,9,19,3,22,72.21,0
Timewell: Trail of Celestes,2022-09-12,3,19,3,22,72.21,0
Idling Idol,2022-01-06,12,19,3,22,72.21,0
DESTROY Simulator,2022-01-28,5,19,3,22,72.21,0
IRON GUARD,2022-04-26,14,19,3,22,72.21,0
キラキラミラ　８人の遺伝子異常者と血の幽霊,2022-10-27,16,19,3,22,72.21,0
国際指定怪異123号 廃村,2022-07-25,31,19,3,22,72.21,0
作死吧！UP主！,2022-03-11,37,41,9,50,72.2,0
White Paper,2022-07-12,50,41,9,50,72.2,0
Animal Wish,2022-09-09,14,41,9,50,72.2,0
TRADER LIFE SIMULATOR 2,2022-12-08,168,201,59,260,72.19,17
How to Build a Magnificent Kingdom,2022-08-27,573,210,62,272,72.18,6
Momo Mother Bird: Final Story,2022-07-28,30,210,62,272,72.18,3
One Hell of a Week,2022-04-28,4,6,0,6,72.17,0
Qorena,2022-07-06,11,6,0,6,72.17,0
Stella Pastoris,2022-10-14,2,6,0,6,72.17,0
Klondike Solitaire Collection,2022-03-29,5,6,0,6,72.17,1
战地细胞（Battlefield Cell）,2022-08-04,2,6,0,6,72.17,0
GrappleWell,2022-07-21,2,6,0,6,72.17,0
The Legends of Tynedale,2022-02-24,3,6,0,6,72.17,0
Hotel Transylvania: Scary-Tale Adventures,2022-03-11,4,6,0,6,72.17,1
If Fusion Were That Easy,2022-10-31,7,6,0,6,72.17,0
On Key Up: A Game for Keyboards,2022-03-08,4,6,0,6,72.17,0
GOC Royale,2022-05-19,9,6,0,6,72.17,0
The Last Bastion,2022-06-15,3,6,0,6,72.17,0
Mages Defense,2022-09-09,2,6,0,6,72.17,0
Evasive Maneuvers,2022-08-31,8,6,0,6,72.17,0
Roze Blud,2022-02-02,7,6,0,6,72.17,0
Minigolf,2022-12-22,5,6,0,6,72.17,0
Islandville: A New Home,2022-04-29,17,6,0,6,72.17,1
DotStrike,2022-04-23,3,6,0,6,72.17,0
Get-A-Grip Chip and the Body Bugs,2022-05-12,3,6,0,6,72.17,0
The Forgotten Isles,2022-04-17,2,6,0,6,72.17,0
Run Doodleguy!,2022-11-21,5,6,0,6,72.17,0
Castle Greyrot,2022-07-11,3,6,0,6,72.17,0
Stellona,2022-07-29,3,6,0,6,72.17,0
Empire Chronicles,2022-09-22,5,6,0,6,72.17,1
Animal Rivals: Up In The Air,2022-04-04,16,6,0,6,72.17,0
Silver Blue,2022-11-11,7,6,0,6,72.17,1
Our Mountain,2022-09-27,2,6,0,6,72.17,0
Asteroid 5,2022-01-14,2,6,0,6,72.17,0
Heroes of Yore,2022-10-06,3,6,0,6,72.17,0
Gedaria,2022-01-08,6,6,0,6,72.17,0
The Ancient Art of War in the Skies,2022-01-20,3,6,0,6,72.17,0
Aspect,2022-05-20,4,6,0,6,72.17,1
Aspect,2022-05-20,4,6,0,6,72.17,0
Aspect,2018-12-04,2,3,6,9,41.67,1
Aspect,2018-12-04,2,3,6,9,41.67,0
Deep Space Outpost,2022-05-06,5,6,0,6,72.17,0
12 Labours of Hercules XIII: Wonder-ful Builder,2022-01-03,25,6,0,6,72.17,0
Her Jentle Hi-ness,2022-03-24,7,6,0,6,72.17,0
Pandea Stones,2022-08-18,1,6,0,6,72.17,0
Perish Song,2022-11-03,5,6,0,6,72.17,0
Spectrum,2022-03-01,4,6,0,6,72.17,0
Spectrum,2022-03-01,4,6,0,6,72.17,0
Spectrum,2022-03-01,4,6,0,6,72.17,0
Spectrum,2021-12-19,4,3,2,5,54.17,0
Spectrum,2021-12-19,4,3,2,5,54.17,0
Spectrum,2021-12-19,4,3,2,5,54.17,0
Spectrum,2016-09-22,622,52,11,63,73.24,0
Spectrum,2016-09-22,622,52,11,63,73.24,0
Spectrum,2016-09-22,622,52,11,63,73.24,0
I Love Finding MORE Cats,2022-02-10,7,6,0,6,72.17,0
Laboratory of Nightmares,2022-03-10,2,6,0,6,72.17,0
Batsumaru,2022-06-11,2,6,0,6,72.17,0
Hamster Blitz!,2022-02-27,3,6,0,6,72.17,0
Precursors: Armored Angels,2022-04-08,3,6,0,6,72.17,0
Fembot Jigsaw,2022-03-30,2,6,0,6,72.17,0
うんこタイピング,2022-11-15,20,6,0,6,72.17,0
Screaming Loaf,2022-03-17,2,6,0,6,72.17,0
A Noite Sem Fim,2022-01-15,2,6,0,6,72.17,0
Nonstop,2022-02-01,2,6,0,6,72.17,0
Maximum Fighterz: Direct Offensive Action,2022-01-11,3,6,0,6,72.17,0
Two of us,2022-01-11,3,6,0,6,72.17,0
Game Dev Arcade,2022-05-10,3,6,0,6,72.17,0
風の祝子 ～早苗さんの妖怪退治～,2022-02-19,3,6,0,6,72.17,0
Escape From Hard Drive,2022-07-11,3,6,0,6,72.17,0
Cursed Quest,2022-03-23,2,6,0,6,72.17,0
The Paper Game,2022-06-21,2,6,0,6,72.17,0
巨 ~Gigantify~,2022-01-23,2,6,0,6,72.17,0
Nevedomo,2022-01-17,2,6,0,6,72.17,0
B-1LL1,2022-03-19,3,6,0,6,72.17,0
Mini Putt Camelot,2022-06-01,4,6,0,6,72.17,0
MotorSim 3,2022-02-01,3,6,0,6,72.17,0
INTO THE CTHULHU MYTHOLOGY,2022-02-04,2,6,0,6,72.17,0
Yeah Yeah Beebiss II,2022-02-03,2,6,0,6,72.17,0
Blobbs: Remastered,2022-07-11,2,6,0,6,72.17,0
Watashi Suzume,2022-11-14,3,6,0,6,72.17,0
Potions!,2022-12-04,5,6,0,6,72.17,0
Armchair Racer,2022-02-09,9,6,0,6,72.17,0
Perfect Balance Collection,2022-02-11,3,6,0,6,72.17,0
她曾经活过啊,2022-02-11,1,6,0,6,72.17,0
Gun Ugly,2022-02-22,2,6,0,6,72.17,0
Familiar,2022-04-19,2,6,0,6,72.17,0
Bitlands,2022-04-29,3,6,0,6,72.17,0
Race On Ice 2022 Pro,2022-02-28,16,6,0,6,72.17,0
Fung Guys,2022-06-04,25,6,0,6,72.17,0
The Lost Oregon City Gold,2022-04-12,2,6,0,6,72.17,0
Frite Medium,2022-04-05,3,6,0,6,72.17,0
Expansion Core,2022-10-10,5,6,0,6,72.17,0
Running in the Y2K,2022-05-10,4,6,0,6,72.17,0
Elephant's Graveyard,2022-05-06,2,6,0,6,72.17,0
Mini Island: Aroma,2022-03-01,3,6,0,6,72.17,0
Vetrex,2022-04-01,3,6,0,6,72.17,0
Saikoro Saiko Seventh Heaven,2022-12-31,9,6,0,6,72.17,0
Ganbaru,2022-06-24,1,6,0,6,72.17,0
Tales of Novariel,2022-03-09,3,6,0,6,72.17,0
Four Winds Fantasy,2022-03-09,2,6,0,6,72.17,0
A Factory Job,2022-03-17,1,6,0,6,72.17,0
侦查故事：风声,2022-11-11,3,6,0,6,72.17,0
Jasper Vice: Legends Untold,2022-08-04,2,6,0,6,72.17,0
Prototype TD 2,2022-03-18,4,6,0,6,72.17,0
The Ambassador's Coterie,2022-03-21,1,6,0,6,72.17,0
Dashing Orange,2022-06-21,2,6,0,6,72.17,0
Galpa the no limbs guy,2022-03-31,1,6,0,6,72.17,0
Lilium,2022-11-11,4,6,0,6,72.17,0
dweeMIXED: Thwee Pack,2022-03-31,2,6,0,6,72.17,0
Tomb Robbing with Friends,2022-07-28,9,6,0,6,72.17,0
Timmy l'escargot,2022-03-30,3,6,0,6,72.17,0
Simple Boxing Drills VR,2022-05-14,3,6,0,6,72.17,0
Arcis Ultima,2022-04-15,2,6,0,6,72.17,0
Goblin Gladiators,2022-08-23,15,6,0,6,72.17,0
Achievement Cage,2022-09-14,3,6,0,6,72.17,0
Cosmic Ascension,2022-04-22,3,6,0,6,72.17,0
Wibble,2022-05-27,4,6,0,6,72.17,0
K9 UPRISING,2022-05-18,2,6,0,6,72.17,0
Your Computer Might Be At Risk,2022-06-17,2,6,0,6,72.17,0
New Year's Eve Miracle,2022-06-20,1,6,0,6,72.17,0
Thieves' Paradise,2022-05-21,4,6,0,6,72.17,0
NEOGEO POCKET COLOR SELECTION Vol.2,2022-11-09,6,6,0,6,72.17,0
Tom's Adventure,2022-05-30,1,6,0,6,72.17,0
Elspell,2022-07-08,2,6,0,6,72.17,0
Little Rhapsody of Game,2022-06-03,5,6,0,6,72.17,0
Beautiful Ukraine,2022-05-27,1,6,0,6,72.17,0
It's Time,2022-06-15,2,6,0,6,72.17,0
Death Bowl,2022-10-28,6,6,0,6,72.17,0
Bonk'd Audio Visualizer,2022-06-16,2,6,0,6,72.17,1
Putin Orcs Defender,2022-07-15,2,6,0,6,72.17,0
Rooftop Garden Simulator,2022-08-01,2,6,0,6,72.17,0
Crush them!碾碎它们！,2022-06-07,8,6,0,6,72.17,0
STRIKERS,2022-10-10,5,6,0,6,72.17,0
Crazy Traffic Racer,2022-07-19,3,6,0,6,72.17,0
Push The Blocks,2022-07-14,3,6,0,6,72.17,0
Don't Die Mr. Robot! DX,2022-08-17,2,6,0,6,72.17,0
The Monster Under Your Skin,2022-08-29,1,6,0,6,72.17,0
徹夜報告書,2022-08-30,22,6,0,6,72.17,0
Chompies!,2022-08-23,5,6,0,6,72.17,0
Flying Ruckus - Multiplayer,2022-07-19,5,6,0,6,72.17,0
Mikaira (Archived),2022-11-18,1,6,0,6,72.17,0
At Home With Step-Sis Simulator,2022-08-24,4,6,0,6,72.17,0
MISSING_CAT,2022-07-19,2,6,0,6,72.17,0
1001 Jigsaw. Cute Cats 2,2022-08-01,2,6,0,6,72.17,0
SHAFTED,2022-10-13,7,6,0,6,72.17,0
PunchBots,2022-09-01,2,6,0,6,72.17,0
OneHanded,2022-07-29,2,6,0,6,72.17,0
Math Tower 2,2022-10-30,2,6,0,6,72.17,0
Hero Hours Contract 2: A Factory for Magical Girls,2022-09-07,3,6,0,6,72.17,0
Odd Guy Meets Odd Farmers,2022-09-08,3,6,0,6,72.17,0
Space Voyage: The Puzzle Game,2022-12-20,3,6,0,6,72.17,0
Monstir Iradicator,2022-10-18,1,6,0,6,72.17,0
Project XLOWS: Keyboard Apocalypse TM,2022-12-01,2,6,0,6,72.17,0
Spam Text,2022-09-01,8,6,0,6,72.17,0
CyberBlocker Complete Edition,2022-10-13,2,6,0,6,72.17,0
Be My Loyal Subject,2022-10-13,4,6,0,6,72.17,0
HUNDRED FIRES: The rising of red star - EPISODE 2,2022-09-09,2,6,0,6,72.17,0
CapoeiRogue: Dandara Cordão de Ouro,2022-09-20,2,6,0,6,72.17,0
Living Legends: The Blue Chamber Collector's Edition,2022-09-12,7,6,0,6,72.17,2
Hallway Defender,2022-10-07,5,6,0,6,72.17,0
Trash Panda: The Adventures of Ricky and Boxman,2022-11-30,3,6,0,6,72.17,0
Gust,2022-10-14,3,6,0,6,72.17,0
Spin Quest,2022-11-30,6,6,0,6,72.17,0
百獣エスケープ,2022-12-25,4,6,0,6,72.17,0
I commissioned some bees 9,2022-11-04,5,6,0,6,72.17,0
Jewel Match Twilight,2022-10-27,16,6,0,6,72.17,2
Missing Pictures : Lee Myung Se,2022-12-01,2,6,0,6,72.17,0
Wrapped With a Kiss,2022-12-12,2,6,0,6,72.17,0
Cat Herders: Couch Coop Cat Corralling!,2022-11-07,4,6,0,6,72.17,0
New Hire,2022-11-15,2,6,0,6,72.17,0
Boat Train,2022-11-25,1,6,0,6,72.17,0
黑匣 Dark Box,2022-12-26,4,6,0,6,72.17,0
One Last Time,2022-11-30,4,6,0,6,72.17,0
Ghost Guy,2022-11-28,3,6,0,6,72.17,0
Eggcelerate! to the North Pole,2022-12-15,3,6,0,6,72.17,0
Ecosphere - Prologue,2022-12-12,2,6,0,6,72.17,0
The Children's Friend,2022-12-24,17,6,0,6,72.17,0
Vampire: The Masquerade - Bloodhunt,2022-04-27,29475,35425,13083,48508,72.13,"1,698"
九州战歌,2022-01-07,597,421,133,554,72.11,30
The Sexorcist,2022-07-28,10,51,12,63,72.1,0
STHELL,2022-03-11,6,30,6,36,72.09,0
Yurukill: The Calumniation Games,2022-07-08,20,30,6,36,72.09,0
Territory,2022-07-09,6,30,6,36,72.09,0
Territory,2022-07-09,6,30,6,36,72.09,0
Territory,2022-05-31,10,23,6,29,68.78,0
Territory,2022-05-31,10,23,6,29,68.78,0
DIMENSIONAL SLAUGHTER,2022-10-11,7,30,6,36,72.09,0
Sneak Thief,2022-05-07,59,1151,388,1539,72.07,10
Solace Crafting,2022-08-02,274,548,177,725,72.06,11
Skullborn,2022-11-05,21,44,10,54,72.06,1
Run Build Pew!,2022-06-06,377,334,104,438,72.05,4
Furry Survivals 18+,2022-11-09,31,37,8,45,72.05,0
Afterlife VR,2022-09-15,10,103,28,131,72.04,0
League Manager 2022,2022-03-24,468,622,203,825,72.03,1
The Living Remain,2022-04-05,28,125,35,160,72.03,0
Kardboard Kings,2022-02-10,203,265,81,346,72.02,3
Tor Eternum,2022-07-15,84,54,13,67,72.01,4
Buccaneers! The New Age of Piracy,2022-03-02,52,77,20,97,71.99,2
Gorilla Soccer,2022-08-13,17,67,17,84,71.95,5
Revenge of the Killer Octopus,2022-11-16,85,47,11,58,71.94,0
Groove Gunner,2022-02-10,7,26,5,31,71.94,0
Grid Force - Mask of the Goddess,2022-09-15,15,26,5,31,71.94,1
Mind Rite,2022-02-20,8,26,5,31,71.94,0
Lewd Life with my Doggy Wife,2022-06-10,10,26,5,31,71.94,0
SCP: Nine-Tailed Fox,2022-02-02,1164,1782,618,2400,71.92,23
Ganryu 2,2022-04-22,9,57,14,71,71.92,0
After the Collapse,2022-09-09,66,124,35,159,71.91,2
战国异闻录,2022-11-16,100,124,35,159,71.91,1
IXION,2022-12-07,17189,7345,2669,10014,71.89,586
Aka,2022-12-15,337,230,70,300,71.88,13
Bouncy Goat Climb,2022-01-10,55,227,69,296,71.88,1
Kung Fu Grand King,2022-04-09,143,105,29,134,71.88,0
Arena 3D,2022-03-02,5,33,7,40,71.87,0
Champion of Venus,2022-04-18,17,33,7,40,71.87,1
Idle Skilling,2022-09-15,6466,1184,405,1589,71.85,869
Hubris,2022-12-07,104,280,87,367,71.85,3
Pleasure Party,2022-01-14,90,145,42,187,71.85,3
Good Company,2022-06-21,1745,1113,380,1493,71.83,60
Soulash,2022-03-04,486,288,90,378,71.81,12
Requisition VR,2022-10-20,107,220,67,287,71.81,1
BLACK WITCHCRAFT,2022-09-27,74,76,20,96,71.81,0
River City Girls Zero,2022-09-21,22,76,20,96,71.81,1
僵尸塔防(Zombie Defence TD),2022-12-10,364,763,256,1019,71.79,20
Dummynation,2022-04-15,48,276,86,362,71.79,8
Destiny of the World,2022-08-22,14,22,4,26,71.78,0
Caapora Adventure - Ojibe's Revenge,2022-04-18,5,22,4,26,71.78,0
What Is Love?,2022-09-30,7,22,4,26,71.78,1
Dreamy Planet,2022-09-15,6,22,4,26,71.78,0
Walk with the Living,2022-01-21,5,22,4,26,71.78,0
The Redress of Mira,2022-07-07,6,22,4,26,71.78,0
Space Ducks: The great escape,2022-05-19,3,22,4,26,71.78,0
Lost Alone Ep.3 - Nonnina,2022-06-17,8,22,4,26,71.78,0
ALPHA-NIGHTHAWK,2022-10-28,5,22,4,26,71.78,0
Torecower,2022-12-23,12,22,4,26,71.78,0
Alchemy Garden,2022-12-12,76,398,128,526,71.77,9
Tvö,2022-08-01,53,255,79,334,71.77,1
Robo Revenge Squad,2022-08-17,26,101,28,129,71.76,1
CEO,2022-05-20,21,53,13,66,71.76,4
Crawl Tactics,2022-12-09,31,43,10,53,71.76,3
純愛貓娘的同居生活,2022-10-11,25,43,10,53,71.76,0
Dreams with Furry 🦊,2022-08-18,13,43,10,53,71.76,0
Batora: Lost Haven,2022-10-20,71,147,43,190,71.74,10
Chrono Survival,2022-12-09,71,66,17,83,71.74,0
Earthling's Undertaking,2022-08-25,1405,577,191,768,71.73,19
GUILT: The Deathless,2022-04-28,16,36,8,44,71.7,0
Soulflow,2022-03-18,11,36,8,44,71.7,0
Strip'Em II,2022-07-29,30,36,8,44,71.7,1
Cuties Hacked: Oh no someone stole my photos!,2022-08-17,10,36,8,44,71.7,2
Golazo 2,2022-09-01,11,56,14,70,71.69,1
侵入：源代码,2022-04-29,7,29,6,35,71.69,0
Transcendence Legacy - Voidswept,2022-04-04,31,29,6,35,71.69,0
Sisters_Possession1,2022-04-14,17,29,6,35,71.69,0
Crown Delights Deli,2022-02-16,9,46,11,57,71.66,0
Narvas,2022-09-03,3,18,3,21,71.63,0
Sausage Fest,2022-03-08,14,18,3,21,71.63,0
TIME BREAKER,2022-05-16,3,18,3,21,71.63,0
Keng's Little Universe,2022-01-14,12,18,3,21,71.63,0
Milf Toys,2022-02-11,4,18,3,21,71.63,0
Decay - a real time interactive experience,2022-02-07,4,18,3,21,71.63,0
ManServant: Yaoi BL Gay Visual Novel,2022-09-21,22,18,3,21,71.63,0
Quest: Escape Dungeon,2022-08-01,6,18,3,21,71.63,0
Put Your Brain On,2022-05-10,2,18,3,21,71.63,0
The Search for Fran 2,2022-06-07,4,18,3,21,71.63,0
Tennis Club Story,2022-11-28,33,18,3,21,71.63,1
Europe Bus Driver,2022-11-18,4,18,3,21,71.63,1
The Shadow People,2022-10-27,6,18,3,21,71.63,0
MagicShop3D,2022-06-19,23,75,20,95,71.62,1
Superior,2022-11-16,36,59,15,74,71.62,1
The Knight Witch,2022-11-29,225,223,69,292,71.6,6
Tower Princess,2022-09-08,87,106,30,136,71.59,0
WWE 2K22,2022-03-11,9535,6909,2550,9459,71.58,646
Godlike Burger,2022-04-21,597,359,116,475,71.58,21
My Boss is a Futanari,2022-02-24,6,62,16,78,71.57,0
King 'n Knight,2022-01-07,30,49,12,61,71.57,0
Hentai Dream,2022-01-17,4,39,9,48,71.57,0
IN THE BUILDING: CATS,2022-11-16,7,39,9,48,71.57,1
Alaloth - Champions of The Four Kingdoms,2022-06-30,472,529,176,705,71.56,4
HALF DEAD 3,2022-09-09,107,324,104,428,71.56,9
Metacell: Genesis,2022-08-19,5,10,1,11,71.55,0
We'll Always Have Paris,2022-04-27,2,10,1,11,71.55,0
新城镇,2022-06-03,3,10,1,11,71.55,0
Fragments Of A Mind,2022-03-25,2,10,1,11,71.55,0
CYNOROID FORSAKEN,2022-06-03,6,10,1,11,71.55,0
I wanna go home,2022-11-04,3,10,1,11,71.55,0
Lofty Quest,2022-03-28,2,10,1,11,71.55,0
The Spanish Privateer,2022-09-16,10,10,1,11,71.55,0
Runnyk,2022-05-04,3,10,1,11,71.55,0
Kombinera,2022-04-07,4,10,1,11,71.55,0
Shootball Arena,2022-12-23,6,10,1,11,71.55,0
Lastone: Behind the Choice,2022-01-21,2,10,1,11,71.55,0
Bubbles shot,2022-01-19,2,10,1,11,71.55,0
Extreme Race,2022-01-21,12,10,1,11,71.55,0
ColdSun,2022-02-09,4,10,1,11,71.55,0
Prayer of the Faithless,2022-05-27,4,10,1,11,71.55,1
Kojimachi,2022-08-09,16,10,1,11,71.55,2
DANGER OF LOSS,2022-02-21,4,10,1,11,71.55,0
Al-Qadim: The Genie's Curse,2022-03-29,8,10,1,11,71.55,1
Chaos Girl,2022-03-10,2,10,1,11,71.55,0
Armored Firestorm,2022-04-04,7,10,1,11,71.55,0
SnakeByte,2022-03-19,2,10,1,11,71.55,0
Harriet: From Slave To Hero,2022-04-02,4,10,1,11,71.55,0
QUIJOTE: Quest for Glory,2022-03-31,2,10,1,11,71.55,0
Puzzle: Nature,2022-04-16,5,10,1,11,71.55,0
KONGEER,2022-05-31,2,10,1,11,71.55,0
One Last Memory - Reimagined,2022-06-10,2,10,1,11,71.55,0
Pitchfork Kingdom,2022-09-23,2,10,1,11,71.55,0
Mechabot Defender,2022-08-03,10,10,1,11,71.55,0
Dark Slime,2022-05-26,5,10,1,11,71.55,0
Crazy Zoo,2022-06-03,2,10,1,11,71.55,0
Bots Crusher Arena,2022-09-01,3,10,1,11,71.55,0
Magneko,2022-08-20,4,10,1,11,71.55,0
Pretty Girls Breakout! PLUS,2022-07-29,3,10,1,11,71.55,0
Climb and Fight: Mafia,2022-09-21,2,10,1,11,71.55,0
Stories school,2022-08-30,2,10,1,11,71.55,0
Spooky Mansion Manager,2022-09-01,4,10,1,11,71.55,0
The Lost Abyss,2022-09-03,3,10,1,11,71.55,0
PUSSY 6,2022-08-26,2,10,1,11,71.55,0
蛮王与女武神,2022-11-18,6,10,1,11,71.55,0
Guilty,2022-09-15,4,10,1,11,71.55,0
Up & Away,2022-11-16,2,10,1,11,71.55,0
Ace Pilot Europe,2022-10-24,4,10,1,11,71.55,0
SEARCH ALL - MICE,2022-11-08,3,10,1,11,71.55,0
Inner Call,2022-10-14,3,10,1,11,71.55,0
Puny BOB,2022-11-17,2,10,1,11,71.55,0
Trader of the Night,2022-10-17,15,10,1,11,71.55,0
CampNight,2022-11-05,3,10,1,11,71.55,0
Lust Colony,2022-12-22,14,10,1,11,71.55,1
Battle of the Lost Continent,2022-11-29,3,10,1,11,71.55,0
VR Jurassic Adventure HD,2022-12-16,1,10,1,11,71.55,0
Purple War,2022-10-21,28,84,23,107,71.54,0
Influence Inc.,2022-05-31,7,14,2,16,71.52,0
Black Lotus Motel,2022-04-20,6,14,2,16,71.52,0
DESKTOP MONKEY,2022-07-15,2,14,2,16,71.52,0
Big Booty Adventures,2022-01-05,7,14,2,16,71.52,0
POORLY drawn but HORNY,2022-03-28,3,14,2,16,71.52,0
Magnus Imago,2022-02-02,4,14,2,16,71.52,0
Ninja Noboken,2022-05-03,3,14,2,16,71.52,0
Tumblefire,2022-02-09,2,14,2,16,71.52,0
Deep Night Runner,2022-02-21,3,14,2,16,71.52,0
Lab Remnants,2022-04-15,3,14,2,16,71.52,0
Thread,2022-10-18,3,14,2,16,71.52,0
Witch Epoch,2022-06-13,3,14,2,16,71.52,0
8-Bit Farm,2022-10-31,25,14,2,16,71.52,0
Pixxxel,2022-08-24,3,14,2,16,71.52,0
City Construction Simulator,2022-10-28,2,14,2,16,71.52,0
MikotoRemake / 铭日记重制版,2022-11-27,3,14,2,16,71.52,0
Nanali in another world,2022-11-19,2,14,2,16,71.52,0
Power Driver,2022-11-21,2,14,2,16,71.52,0
Mist Legacy,2022-09-13,1065,881,303,1184,71.51,110
Yaengard,2022-05-05,101,90,25,115,71.5,0
World Seed,2022-05-17,409,236,74,310,71.49,2
2076 Midway Multiverse,2022-02-03,5,32,7,39,71.49,0
Ship Simulator Realistic,2022-01-11,7,32,7,39,71.49,2
RFVR,2022-07-18,8,32,7,39,71.49,0
Izmir: An Independence Simulator,2022-04-29,6,32,7,39,71.49,1
RO-BOUNCE,2022-05-27,6,32,7,39,71.49,0
Internet Cafe Simulator 2,2022-01-07,3527,6038,2233,8271,71.48,151
主宰飞仙,2022-08-19,54,96,27,123,71.48,2
Archipelago,2022-01-14,16,25,5,30,71.48,0
Archipelago,2022-01-14,16,25,5,30,71.48,0
Archipelago,2016-08-18,3422,39,17,56,63.83,0
Archipelago,2016-08-18,3422,39,17,56,63.83,0
Dungeon Reels Tactics,2022-05-02,22,25,5,30,71.48,0
Desert Revenant,2022-09-22,7,25,5,30,71.48,0
Sinner 97,2022-11-22,5,25,5,30,71.48,0
In The Darkness,2022-09-13,9,25,5,30,71.48,0
Agarta,2022-10-21,35,230,72,302,71.47,0
Monuments Flipper,2022-11-14,222,111,32,143,71.43,10
Destroyer: The U-Boat Hunter,2022-09-28,325,287,92,379,71.42,5
Beholgar,2022-02-04,14,123,36,159,71.42,6
Passed Out: Prologue,2022-10-10,220,301,97,398,71.4,3
Hacker Simulator: Free Trial,2022-02-15,331,298,96,394,71.4,6
Forever To You!,2022-07-26,29,58,15,73,71.39,0
RetroDrift: Retrowave Online Road,2022-01-20,9,58,15,73,71.39,0
BrainBread 2,2022-03-09,1123,3571,1309,4880,71.38,19
星塔星夜MONOBEHEVO,2022-05-31,11,45,11,56,71.37,0
龙魂大冒险,2022-06-10,194,260,83,343,71.35,1
A Hero's Rest,2022-10-12,78,61,16,77,71.35,1
BYTE FYTE (MULTIPLAYER),2022-11-19,9,35,8,43,71.35,0
War Robots: Frontiers,2022-11-24,100,158,48,206,71.34,34
Angel's Awakening,2022-08-26,89,89,25,114,71.34,4
Refund Me If You Can,2022-07-22,19,92,26,118,71.33,0
Virtual Aquarium - Overlay Desktop Game,2022-04-02,83,95,27,122,71.32,3
Desktopia: A Desktop Village Simulator,2022-08-05,247,134,40,174,71.31,2
远征契约,2022-10-21,32,64,17,81,71.31,3
The Backrooms,2022-10-29,8,48,12,60,71.3,2
The Backrooms,2022-10-29,8,48,12,60,71.3,0
The Backrooms,2019-08-01,2,10,37,47,30.23,2
The Backrooms,2019-08-01,2,10,37,47,30.23,0
Lost Ark,2022-02-11,1325305,137424,53849,191273,71.29,"76,246"
Who Pressed Mute on Uncle Marcus?,2022-03-18,60,347,114,461,71.29,2
Dwerve,2022-05-31,610,389,129,518,71.27,0
World Fighting Soccer 22,2022-08-30,9,28,6,34,71.26,0
Trigo,2022-02-18,7,28,6,34,71.26,0
The Last Secret,2022-08-30,7,28,6,34,71.26,0
Crocodile Transformator,2022-10-23,3,28,6,34,71.26,0
Peepo Island,2022-07-18,854,163,50,213,71.25,2
Harlow,2022-03-14,4,21,4,25,71.25,0
Pets and Girls,2022-02-17,3,21,4,25,71.25,0
Grid Slayer,2022-02-02,7,21,4,25,71.25,0
Deadly Infestation,2022-02-14,3,21,4,25,71.25,0
剑冢 Swords Tomb,2022-05-06,22,21,4,25,71.25,0
Chords Enchanter,2022-06-17,5,21,4,25,71.25,0
Goat's Tale 2,2022-11-09,100,21,4,25,71.25,0
Robot Resistors,2022-10-22,8,21,4,25,71.25,0
ACHIEVEMENTS CITY,2022-09-12,3,21,4,25,71.25,0
姬恋~缚羽的欠片 纯净中文版,2022-11-14,9,21,4,25,71.25,0
Rhythm Journey,2022-04-17,20,73,20,93,71.24,0
Hentai War,2022-12-09,5,38,9,47,71.23,0
Pinch of Fighting Girls,2022-08-09,19,38,9,47,71.23,1
Hentai Bodysuit,2022-10-28,7,38,9,47,71.23,0
SILT,2022-06-01,142,255,82,337,71.22,6
Knights of the Chalice 2,2022-03-25,51,76,21,97,71.22,1
AfterHours,2022-02-18,93,306,100,406,71.21,2
Bombagun,2022-01-26,36,79,22,101,71.21,1
Tower of Fantasy,2022-10-20,7210,4779,1785,6564,71.19,"2,892"
Esse Proxy,2022-07-11,41,85,24,109,71.18,0
Hazel Sky,2022-07-20,49,115,34,149,71.17,1
Deadness,2022-02-22,11,103,30,133,71.16,0
Argentum 20,2022-04-29,500,271,88,359,71.15,57
There Is No Light,2022-09-19,612,366,122,488,71.12,4
ReFactory,2022-04-08,54,60,16,76,71.12,1
BITGUN,2022-04-29,4,31,7,38,71.1,0
The Pizza Courier,2022-09-23,6,31,7,38,71.1,0
AOI,2022-12-15,14,31,7,38,71.1,0
Train Life - A Railway Simulator,2022-08-25,407,879,310,1189,71.09,43
Hot Lap League,2022-08-23,21,63,17,80,71.09,3
Eclipse,2022-09-27,9,132,40,172,71.08,0
Endless waves survival,2022-06-14,132,132,40,172,71.08,0
Soul Scathe,2022-02-18,10,44,11,55,71.07,0
Three Kingdom: The Journey,2022-01-07,21,44,11,55,71.07,1
Void Marauders,2022-03-29,23,44,11,55,71.07,1
The Hentai Memory,2022-03-09,60,44,11,55,71.07,40
Brave survivors,2022-09-30,15,44,11,55,71.07,0
Haisonmeguri,2022-07-16,81,69,19,88,71.05,0
Dungeons of Edera,2022-06-16,326,690,241,931,71.04,15
谜语女孩,2022-06-17,32,81,23,104,71.02,0
刻印战记：冰冻之剑 RE,2022-09-29,94,99,29,128,71.01,0
Dark Quest 3,2022-05-04,84,93,27,120,71.01,2
Kamikaze Kommittee Ouka 2,2022-02-05,163,90,26,116,71.01,0
Pro Basketball Manager 2023,2022-11-10,83,90,26,116,71.01,34
Mage Rage,2022-03-22,3,17,3,20,71.0,0
Queenchantment,2022-03-04,9,17,3,20,71.0,0
Fragmented Memories,2022-05-09,7,17,3,20,71.0,0
Late photographer 2,2022-02-03,9,17,3,20,71.0,0
LIP! Lewd Idol Project Vol. 2,2022-12-15,19,17,3,20,71.0,1
Banana Hunter,2022-03-02,3,17,3,20,71.0,0
Digital Diamond Baseball V10,2022-03-31,26,17,3,20,71.0,6
Emorrior,2022-10-01,6,17,3,20,71.0,0
Odd One Out,2022-06-26,5,17,3,20,71.0,1
69 Penny Hot,2022-08-08,5,17,3,20,71.0,0
Death in the Night,2022-11-21,4,17,3,20,71.0,0
Reilla ~Sweets Adventure~,2022-10-04,5,17,3,20,71.0,0
Port Cranes : Container Age,2022-10-21,13,17,3,20,71.0,0
Police Radar,2022-09-02,2,17,3,20,71.0,0
伏魔天师,2022-11-04,10,17,3,20,71.0,0
Contrast & Girls,2022-08-25,2,17,3,20,71.0,0
Geometric Sniper - Z,2022-12-19,4,24,5,29,70.99,0
The Tribulation Entanglement,2022-02-06,3,24,5,29,70.99,0
Anime Armpits,2022-05-25,3,24,5,29,70.99,0
Meat & Greed,2022-06-07,5,24,5,29,70.99,0
Noclipped,2022-10-04,11,24,5,29,70.99,0
ToS Gamepad Tester,2022-08-27,8,24,5,29,70.99,0
Funeral,2022-11-23,3,24,5,29,70.99,0
Gladius,2022-10-29,14,186,59,245,70.98,0
River City Saga: Three Kingdoms,2022-07-20,436,137,42,179,70.98,4
Swarm the City,2022-06-16,131,137,42,179,70.98,2
NOBUNAGA'S AMBITION: Awakening,2022-07-21,11783,940,335,1275,70.97,376
Magicians And Monsters,2022-08-29,26,50,13,63,70.97,1
房地产大亨,2022-08-05,1113,307,102,409,70.96,2
大富翁少女,2022-01-11,158,217,70,287,70.95,0
百年王国,2022-02-03,72,53,14,67,70.93,0
Her Name Was Fire,2022-10-11,162,171,54,225,70.91,0
Miner Ultra Adventures 2,2022-05-12,34,275,91,366,70.89,0
TombStar,2022-07-20,64,59,16,75,70.88,0
Re:Turn 2 - Runaway,2022-01-28,10,37,9,46,70.88,0
The Lord of the Parties,2022-06-30,34,37,9,46,70.88,0
Crown of Pain,2022-02-15,21,37,9,46,70.88,0
无双剑士的后宫生活,2022-06-18,290,136,42,178,70.86,1
No man`s Island Prologue,2022-08-01,115,65,18,83,70.85,1
F1® Manager 2022,2022-08-30,25575,6784,2605,9389,70.84,"3,227"
Dinosaur Fossil Hunter,2022-05-04,855,461,159,620,70.84,21
Cowboy Life Simulator: Prologue,2022-01-06,91,153,48,201,70.84,3
The Gametrekking Omnibus,2022-12-05,2,5,0,5,70.84,0
SKYRAID,2022-09-07,9,5,0,5,70.84,0
Be Vigilant!,2022-01-24,13,5,0,5,70.84,0
N-GON,2022-10-11,2,5,0,5,70.84,0
Beauty Paradise,2022-05-20,11,5,0,5,70.84,0
Dofense,2022-05-16,4,5,0,5,70.84,0
Music_is_the_Language,2022-05-18,1,5,0,5,70.84,0
Beyond Hope,2022-11-17,4,5,0,5,70.84,0
Push Blox,2022-06-02,3,5,0,5,70.84,0
Presidential Running Games,2022-01-21,2,5,0,5,70.84,0
GreedyCorgi,2022-01-21,3,5,0,5,70.84,0
Death Cube,2022-05-12,2,5,0,5,70.84,0
Personal Rocket,2022-01-31,2,5,0,5,70.84,0
The Dream of Shadowlands Episode 2,2022-06-23,3,5,0,5,70.84,0
Stream Toys by Zokya,2022-07-01,4,5,0,5,70.84,0
Re:Kuroi,2022-01-06,4,5,0,5,70.84,0
Pandemic Pandemonium,2022-01-21,1,5,0,5,70.84,0
Abridge,2022-10-14,3,5,0,5,70.84,0
ZONERS,2022-08-02,2,5,0,5,70.84,0
Endless Thief: a fluffy stealth adventure,2022-05-26,2,5,0,5,70.84,0
Panmorphia: Awakened,2022-04-28,4,5,0,5,70.84,0
DROPSHIP,2022-11-30,2,5,0,5,70.84,1
Poulet Poulet,2022-07-28,3,5,0,5,70.84,0
James Peris 2: The fountain of eternal drunkenness - UNCUT AND UNCENSORED,2022-11-23,3,5,0,5,70.84,0
Mrs. Fantastic's Freaky Figurine Shop,2022-06-24,4,5,0,5,70.84,0
Battery-ouT,2022-03-13,3,5,0,5,70.84,0
My Story,2022-01-08,6,5,0,5,70.84,0
Barn Finders VR,2022-06-02,5,5,0,5,70.84,0
NeverDeath,2022-04-25,2,5,0,5,70.84,0
Volcanon,2022-03-31,6,5,0,5,70.84,0
Daydream,2022-06-02,7,5,0,5,70.84,0
Daydream,2022-06-02,7,5,0,5,70.84,0
Daydream,2018-12-26,1,0,1,1,40.58,0
Daydream,2018-12-26,1,0,1,1,40.58,0
Strings of Divinity | The Spell Plague,2022-01-27,3,5,0,5,70.84,0
Pirated Code: Admin Edition,2022-11-03,3,5,0,5,70.84,0
Ari's Journey,2022-03-03,2,5,0,5,70.84,0
Captain Diarrhea and The Shartening,2022-06-22,1,5,0,5,70.84,0
Ultimaze,2022-06-28,2,5,0,5,70.84,0
I Am 1,2022-06-17,3,5,0,5,70.84,0
SquareMan,2022-02-05,4,5,0,5,70.84,0
Stop the Saturnians!,2022-02-18,3,5,0,5,70.84,0
Book Hunter,2022-02-04,2,5,0,5,70.84,0
Argonauts Agency: Missing Daughter,2022-01-17,8,5,0,5,70.84,0
Fuchian Chronicles,2022-01-06,3,5,0,5,70.84,0
Ambition Record,2022-02-04,9,5,0,5,70.84,0
Nora: The Wannabe Alchemist,2022-05-26,5,5,0,5,70.84,0
Spartan,2022-10-17,9,5,0,5,70.84,6
Spartan,2022-10-17,9,5,0,5,70.84,0
Spartan,2017-10-02,3,17,4,21,68.75,6
Spartan,2017-10-02,3,17,4,21,68.75,0
Blankiball: The Drinking Game,2022-09-14,4,5,0,5,70.84,0
How to Fool a Liar King Remastered,2022-04-07,4,5,0,5,70.84,0
Retro TV Game Collection,2022-02-21,2,5,0,5,70.84,0
HOSTLIGHT,2022-07-22,3,5,0,5,70.84,0
Jester Street : Card-Counting Trainer,2022-01-22,2,5,0,5,70.84,0
Perfect Balance,2022-01-01,48,5,0,5,70.84,0
Breaking Newton,2022-03-02,1,5,0,5,70.84,0
Quest for Cathay Kingdom,2022-03-18,2,5,0,5,70.84,0
Run Run Piñata,2022-01-30,5,5,0,5,70.84,1
Bunny Box Breakout,2022-10-26,1,5,0,5,70.84,0
Safe and Sound - Indie Game,2022-02-25,2,5,0,5,70.84,0
Jules,2022-01-21,2,5,0,5,70.84,0
Omi Oh My AI,2022-09-02,4,5,0,5,70.84,0
Orbital Mechanics,2022-05-06,2,5,0,5,70.84,0
欢迎回家-Welcome Home,2022-02-15,5,5,0,5,70.84,0
Elven Warmaiden,2022-02-03,2,5,0,5,70.84,0
ELEVATED,2022-04-14,22,5,0,5,70.84,0
CellSar,2022-04-26,3,5,0,5,70.84,0
Cute Snake,2022-03-15,3,5,0,5,70.84,0
Juno 06,2022-11-04,3,5,0,5,70.84,0
Ploc,2022-02-17,2,5,0,5,70.84,0
Love on Beach,2022-03-03,3,5,0,5,70.84,0
Everplast,2022-02-24,3,5,0,5,70.84,0
Undeads vs Humans,2022-03-01,2,5,0,5,70.84,0
DuolBots,2022-08-31,5,5,0,5,70.84,0
Reversilly,2022-04-14,8,5,0,5,70.84,0
12 Labours of Hercules XIV: Message in a Bottle,2022-10-24,28,5,0,5,70.84,3
Path Of Destruction,2022-08-13,6,5,0,5,70.84,0
Mythic Defender,2022-04-23,2,5,0,5,70.84,0
Calmie Dots,2022-05-16,2,5,0,5,70.84,0
Quoin,2022-10-03,2,5,0,5,70.84,0
Zap Dem Rats,2022-03-30,2,5,0,5,70.84,0
Fruit Basket TV,2022-06-16,7,5,0,5,70.84,0
Light The Lamp Hockey,2022-11-15,2,5,0,5,70.84,0
OUTLANDER,2022-04-04,1,5,0,5,70.84,0
Down n' Up,2022-07-07,2,5,0,5,70.84,0
STAR MATH: Interstellar Rogue 2,2022-07-21,4,5,0,5,70.84,0
Neon Flash II,2022-04-11,3,5,0,5,70.84,0
Lovely Moments: Dad and daughter,2022-07-09,2,5,0,5,70.84,0
Paranormal Simulator,2022-05-12,3,5,0,5,70.84,0
Pirates - Digital Strategy Game,2022-12-02,7,5,0,5,70.84,0
The Last Man,2022-05-20,3,5,0,5,70.84,0
Beat The Clock,2022-06-01,3,5,0,5,70.84,0
Project Nautilus,2022-05-06,3,5,0,5,70.84,0
Dash Shooters,2022-08-01,1,5,0,5,70.84,0
Arsilon,2022-05-26,2,5,0,5,70.84,0
Edge Run,2022-04-25,2,5,0,5,70.84,0
Doggo Estates,2022-12-01,4,5,0,5,70.84,0
Sisters_Possession2,2022-05-17,5,5,0,5,70.84,0
HopDodge,2022-06-01,5,5,0,5,70.84,0
Eshe's Wish Adventure,2022-05-09,3,5,0,5,70.84,0
Running Over Zombies,2022-07-06,5,5,0,5,70.84,0
Chronicle of Forgotten Times: Pawn of the Gods,2022-06-02,2,5,0,5,70.84,0
CARROT: Pancakes and Waffles,2022-08-27,2,5,0,5,70.84,0
Metal World: Street Scraps,2022-05-20,2,5,0,5,70.84,0
Fight For It,2022-08-03,4,5,0,5,70.84,0
Blitz in the Paper Kingdom,2022-06-17,3,5,0,5,70.84,0
NanoHive,2022-09-30,4,5,0,5,70.84,0
Enter the Cum™: an Erotic Porn Sexual Pleasure!,2022-06-10,1,5,0,5,70.84,0
FunnyPizzaLand 2,2022-10-08,2,5,0,5,70.84,0
BOOM!,2022-06-03,2,5,0,5,70.84,0
Wizcave,2022-08-19,1,5,0,5,70.84,0
Nade Nade Onna no Ko 7: Imprisonment Sex Story,2022-09-09,5,5,0,5,70.84,0
Hide And Seek Scramble!,2022-06-14,7,5,0,5,70.84,0
Ye Olde Cribbage Club,2022-06-15,3,5,0,5,70.84,0
Niravasi,2022-07-06,2,5,0,5,70.84,0
L-Racers,2022-07-03,2,5,0,5,70.84,0
KaBoom!,2022-08-22,1,5,0,5,70.84,0
Junkyard War,2022-07-01,2,5,0,5,70.84,0
Vain Ascendance,2022-08-05,3,5,0,5,70.84,0
Tater Spud,2022-07-29,2,5,0,5,70.84,0
Streamers' Secret Life,2022-11-16,2,5,0,5,70.84,0
Harry Is A Porter,2022-08-13,2,5,0,5,70.84,0
Acanthoceras,2022-07-21,2,5,0,5,70.84,0
FREM Sprite32!,2022-10-17,4,5,0,5,70.84,0
传颂的种族 The Celebrated Race,2022-07-12,3,5,0,5,70.84,0
Cat Dungeon,2022-08-05,3,5,0,5,70.84,0
DodgeKing,2022-10-07,2,5,0,5,70.84,0
Try Again,2022-10-07,2,5,0,5,70.84,0
Tap the Blocks,2022-09-22,3,5,0,5,70.84,0
Klaystar,2022-09-17,6,5,0,5,70.84,0
Apollo's Adventure,2022-08-09,6,5,0,5,70.84,0
STARR RINGER,2022-10-07,3,5,0,5,70.84,0
Redhot Rabbit,2022-08-16,2,5,0,5,70.84,0
EvoLife,2022-09-16,6,5,0,5,70.84,1
Little Hellions,2022-10-31,3,5,0,5,70.84,0
Moving Jigsaw Puzzles,2022-11-22,2,5,0,5,70.84,0
进入后室Get into Backrooms,2022-08-24,2,5,0,5,70.84,0
Bogey Brian,2022-09-30,4,5,0,5,70.84,0
Furry Hentai Tangram,2022-11-25,2,5,0,5,70.84,0
Square Off,2022-10-01,4,5,0,5,70.84,0
Double Trouble,2022-09-13,3,5,0,5,70.84,0
DeerHunterFan.com TV - The Season,2022-10-07,3,5,0,5,70.84,0
路地を曲がれば～海峡の故郷～,2022-10-14,2,5,0,5,70.84,0
SGS Okinawa,2022-11-21,4,5,0,5,70.84,1
Decopins,2022-11-04,4,5,0,5,70.84,0
Don't Hide,2022-09-13,2,5,0,5,70.84,0
荆轲新传（重制版）,2022-10-01,10,5,0,5,70.84,0
牌师,2022-09-26,7,5,0,5,70.84,0
Milita Aventuro,2022-09-29,3,5,0,5,70.84,0
Planet Barren Objective,2022-09-26,2,5,0,5,70.84,0
Hidden Object Vacation,2022-09-19,6,5,0,5,70.84,0
Strength & Virtue: Lord of Midchester,2022-12-16,3,5,0,5,70.84,0
Horror Hotel,2022-10-23,1,5,0,5,70.84,0
Crush Penguin,2022-10-15,1,5,0,5,70.84,0
What They Don't Sea,2022-11-01,3,5,0,5,70.84,0
Duck Race,2022-11-12,2,5,0,5,70.84,1
Super Jumpy Ball,2022-11-11,3,5,0,5,70.84,0
I Love Finding Birds,2022-12-19,5,5,0,5,70.84,0
Orbtangle,2022-10-28,3,5,0,5,70.84,0
Frog In the Well,2022-10-18,2,5,0,5,70.84,0
A Potion For Chamomile,2022-10-21,1,5,0,5,70.84,0
Banana Quest,2022-10-23,2,5,0,5,70.84,0
Missing Pictures: Tsai Ming-Lang,2022-12-01,1,5,0,5,70.84,0
Missing Pictures : Abel Ferrara,2022-12-02,2,5,0,5,70.84,0
CAMPING,2022-11-03,2,5,0,5,70.84,0
Princess Dating Sim,2022-12-05,2,5,0,5,70.84,0
Planet Breakout 2,2022-12-13,3,5,0,5,70.84,0
circloO,2022-11-14,3,5,0,5,70.84,1
リフトピア　もうひとのせ！,2022-11-29,1,5,0,5,70.84,0
My Boss' Wife is My Ex ~Reluctantly Drowning in Sex Deals After Hours~,2022-12-20,3,5,0,5,70.84,0
Obscene Medical Records of a Married Nurse,2022-12-20,1,5,0,5,70.84,0
Jump Dash Soar,2022-12-09,4,5,0,5,70.84,0
Robbie's Tale,2022-12-07,4,5,0,5,70.84,0
CodingPack,2022-12-25,2,5,0,5,70.84,0
Lost Abroad Café,2022-12-31,3,5,0,5,70.84,0
ThanksKilling Day,2022-12-31,2,5,0,5,70.84,0
Grievous Survivors,2022-12-21,3,5,0,5,70.84,0
ResttW,2022-12-25,2,5,0,5,70.84,0
GRID Legends,2022-02-24,455,1171,425,1596,70.83,122
PunjiVR,2022-07-15,6,40,10,50,70.81,0
Rising Mist,2022-02-24,10,27,6,33,70.81,0
Firelight Fantasy: Vengeance,2022-05-06,7,27,6,33,70.81,0
PIXELS: Digital Creatures,2022-07-11,10,27,6,33,70.81,0
Bouldeurdache,2022-02-05,4,27,6,33,70.81,0
Naxos,2022-05-09,6,27,6,33,70.81,0
Gamebook Edgar A. Poe: The Oval Portrait,2022-06-23,5,27,6,33,70.81,0
Microbes and Machines,2022-09-03,11,27,6,33,70.81,0
Super Weapon Master,2022-08-22,8,27,6,33,70.81,0
Afterglitch,2022-12-09,4,13,2,15,70.75,0
get REKTorized,2022-07-07,7,13,2,15,70.75,0
Hirilun,2022-03-14,4,13,2,15,70.75,0
Hope's Journey: A Therapeutic Experience,2022-04-15,2,13,2,15,70.75,0
Camp Palut,2022-06-15,5,13,2,15,70.75,0
BangBang PewPew,2022-04-08,4,13,2,15,70.75,0
VRkanoid - Brick Breaking Game,2022-03-16,2,13,2,15,70.75,0
Road Cards,2022-01-23,3,13,2,15,70.75,0
Alchemist of War,2022-01-17,3,13,2,15,70.75,0
Total CATastrophe,2022-02-06,4,13,2,15,70.75,0
Timberman VR,2022-08-16,5,13,2,15,70.75,0
Rescue Team: Heist of the Century,2022-03-30,23,13,2,15,70.75,2
Pixel Trouble,2022-03-02,4,13,2,15,70.75,0
Roxy Raccoon's Bowling Bash,2022-08-23,2,13,2,15,70.75,0
Pixel Pirate,2022-03-18,3,13,2,15,70.75,0
Tales of Fire,2022-06-17,3,13,2,15,70.75,0
The Kobolds Left Behind,2022-07-07,2,13,2,15,70.75,0
Shadelight,2022-09-23,3,13,2,15,70.75,0
For What Will Come,2022-10-29,5,13,2,15,70.75,0
New Tanks,2022-08-08,3,13,2,15,70.75,0
终末方舟 序,2022-07-19,5,13,2,15,70.75,0
Harpoon,2022-07-23,3,13,2,15,70.75,0
Die O' Clock,2022-11-29,7,13,2,15,70.75,0
Robot Tormod,2022-12-20,2,13,2,15,70.75,0
Hook&Loop,2022-12-01,3,13,2,15,70.75,0
Nick Bounty - The Goat in the Grey Fedora: Remastered,2022-10-03,6,13,2,15,70.75,0
Let's Park Backyard Edition,2022-09-05,2,13,2,15,70.75,0
Actua Soccer 2,2022-10-10,6,13,2,15,70.75,0
Lion King Simulator,2022-10-19,3,13,2,15,70.75,0
ISO,2022-11-28,5,13,2,15,70.75,0
PUB FASCINATION,2022-11-22,5,13,2,15,70.75,0
Geolosys,2022-11-19,2,13,2,15,70.75,0
Jewel Match Winter Wonderland 2 Collector's Edition,2022-12-15,23,13,2,15,70.75,6
Metal Mind,2022-04-25,343,286,96,382,70.72,0
Bard Idle,2022-09-22,1012,275,92,367,70.72,214
VR NSFW,2022-03-17,7,100,30,130,70.72,0
Levitation Simulator,2022-01-27,27,46,12,58,70.72,0
Idle TD: Heroes vs Zombies,2022-01-25,122,97,29,126,70.71,10
无二解药,2022-06-22,6,30,7,37,70.68,0
Logicality,2022-06-14,9,30,7,37,70.68,0
Mutant Meltdown,2022-09-09,18,30,7,37,70.68,0
Alchemist Tris's Desire,2022-10-27,19,30,7,37,70.68,0
The Lost and The Wicked,2022-03-24,3,20,4,24,70.68,0
Firekeep,2022-04-19,4,20,4,24,70.68,0
Coins Invaders,2022-02-15,3,20,4,24,70.68,0
PAW Patrol: Grand Prix,2022-09-30,21,20,4,24,70.68,3
Dead No Head,2022-01-20,3,20,4,24,70.68,0
Dead End Aegis: Gaiden,2022-01-02,8,20,4,24,70.68,0
EXIT - The Curse of Ophir,2022-06-29,13,20,4,24,70.68,2
CARDMON,2022-05-19,7,20,4,24,70.68,0
CATAIRE,2022-09-23,6,20,4,24,70.68,0
Winning Post 9 2022,2022-04-14,4727,85,25,110,70.67,225
WoMen in Science,2022-08-15,27,52,14,66,70.67,0
The Monster Within,2022-10-22,19,52,14,66,70.67,0
My Yandere is a Futanari,2022-04-04,5,52,14,66,70.67,0
Circus Electrique,2022-09-06,280,157,50,207,70.66,7
ORX,2022-08-30,925,364,125,489,70.65,16
SOL CRESTA,2022-02-22,44,61,17,78,70.64,0
Beasts of Burden,2022-04-06,31,61,17,78,70.64,0
Indecent Details - Find the Difference,2022-04-05,43,111,34,145,70.63,1
Fueled Up,2022-10-13,207,67,19,86,70.63,0
Child of Lothian,2022-06-16,31,67,19,86,70.63,4
KAREN SEES,2022-02-04,3,33,8,41,70.59,0
MetälBörn,2022-07-21,9,33,8,41,70.59,1
Succubus Girl Story,2022-03-04,12,102,31,133,70.58,0
WTC : Relentless Protagonist,2022-09-28,2,9,1,10,70.57,0
Social Services of the Doomed,2022-06-23,24,9,1,10,70.57,0
Crazy Chicken Xtreme,2022-08-22,4,9,1,10,70.57,0
Frisbros,2022-03-18,4,9,1,10,70.57,0
Venice 2089 ,2022-10-14,9,9,1,10,70.57,0
HeadCount,2022-04-18,2,9,1,10,70.57,0
Ortheo,2022-05-21,2,9,1,10,70.57,0
Being Loved,2022-02-17,2,9,1,10,70.57,0
The Evolving World: Catalyst Wake,2022-02-10,3,9,1,10,70.57,0
Papertris,2022-03-01,6,9,1,10,70.57,0
Mayflower Reflections,2022-02-24,12,9,1,10,70.57,0
Froggo Swing 'n Grapple,2022-11-30,3,9,1,10,70.57,0
Professor of Magical Studies,2022-12-08,40,9,1,10,70.57,1
Tribal.Games,2022-04-14,7,9,1,10,70.57,0
Dream Of The Hikikomori,2022-02-04,2,9,1,10,70.57,0
Word of the Law: Death Mask Collector's Edition,2022-01-11,7,9,1,10,70.57,0
Japanese DoJo,2022-02-02,2,9,1,10,70.57,0
System Critical: The Race Against Time,2022-07-15,3,9,1,10,70.57,0
VIrus Killer,2022-01-24,2,9,1,10,70.57,0
Super Rolling Heroes,2022-03-23,5,9,1,10,70.57,0
New Century Galaxy Legend,2022-02-23,4,9,1,10,70.57,0
Pasajeros,2022-03-12,2,9,1,10,70.57,0
Battle of Finland: Winter War,2022-03-14,2,9,1,10,70.57,0
Yosemite Forest Ranger,2022-05-26,6,9,1,10,70.57,0
Cosmoblaster Exodia,2022-03-14,4,9,1,10,70.57,0
Golfing In Aether,2022-09-23,6,9,1,10,70.57,0
Slackline VR,2022-03-25,2,9,1,10,70.57,0
Shady Business,2022-03-30,4,9,1,10,70.57,0
Tilefinder,2022-07-12,4,9,1,10,70.57,0
Narcotics Ninja,2022-05-02,4,9,1,10,70.57,0
Gemlands,2022-04-10,2,9,1,10,70.57,0
Dino-D,2022-05-06,3,9,1,10,70.57,0
Collapsed,2022-08-09,3,9,1,10,70.57,0
New Yankee: Battle for the Bride,2022-05-11,25,9,1,10,70.57,1
Lunatia Covenant -Pale White Agent-,2022-05-10,6,9,1,10,70.57,0
Spacemancer,2022-05-18,4,9,1,10,70.57,0
Fucking Hell,2022-06-02,3,9,1,10,70.57,0
Zaxterion - Space Frenzy,2022-09-10,3,9,1,10,70.57,0
BTank,2022-09-01,3,9,1,10,70.57,0
Ready or Not,2022-07-08,3,9,1,10,70.57,0
Ready or Not,2022-07-08,3,9,1,10,70.57,"2,559"
Ready or Not,2021-12-17,19621,93231,8524,101755,90.33,0
Ready or Not,2021-12-17,19621,93231,8524,101755,90.33,"2,559"
Astro,2022-09-21,3,9,1,10,70.57,0
My Agent is a Futanari,2022-09-26,5,9,1,10,70.57,0
No Time For Caution,2022-12-09,3,9,1,10,70.57,0
Escape,2022-08-16,4,9,1,10,70.57,0
Escape,2022-08-16,4,9,1,10,70.57,0
Escape,2022-08-16,4,9,1,10,70.57,0
Escape,2022-08-16,4,9,1,10,70.57,0
Escape,2022-08-16,4,9,1,10,70.57,0
Escape,2022-08-16,4,9,1,10,70.57,0
Escape,2022-01-15,32,92,31,123,68.99,0
Escape,2022-01-15,32,92,31,123,68.99,0
Escape,2022-01-15,32,92,31,123,68.99,0
Escape,2022-01-15,32,92,31,123,68.99,0
Escape,2022-01-15,32,92,31,123,68.99,0
Escape,2022-01-15,32,92,31,123,68.99,0
Escape,2022-02-07,1,2,1,3,55.69,0
Escape,2022-02-07,1,2,1,3,55.69,0
Escape,2022-02-07,1,2,1,3,55.69,0
Escape,2022-02-07,1,2,1,3,55.69,0
Escape,2022-02-07,1,2,1,3,55.69,0
Escape,2022-02-07,1,2,1,3,55.69,0
Escape,2021-05-05,3,2,4,6,42.61,0
Escape,2021-05-05,3,2,4,6,42.61,0
Escape,2021-05-05,3,2,4,6,42.61,0
Escape,2021-05-05,3,2,4,6,42.61,0
Escape,2021-05-05,3,2,4,6,42.61,0
Escape,2021-05-05,3,2,4,6,42.61,0
Escape,2018-01-28,3,7,23,30,32.82,0
Escape,2018-01-28,3,7,23,30,32.82,0
Escape,2018-01-28,3,7,23,30,32.82,0
Escape,2018-01-28,3,7,23,30,32.82,0
Escape,2018-01-28,3,7,23,30,32.82,0
Escape,2018-01-28,3,7,23,30,32.82,0
Escape,2015-04-20,45,173,108,281,59.45,0
Escape,2015-04-20,45,173,108,281,59.45,0
Escape,2015-04-20,45,173,108,281,59.45,0
Escape,2015-04-20,45,173,108,281,59.45,0
Escape,2015-04-20,45,173,108,281,59.45,0
Escape,2015-04-20,45,173,108,281,59.45,0
Get the Ball Rolling,2022-08-25,2,9,1,10,70.57,0
Jade Order,2022-08-25,2,9,1,10,70.57,0
DragonScales 1-7 Collection,2022-08-26,3,9,1,10,70.57,0
Missile Command: Recharged,2022-11-01,4,9,1,10,70.57,1
Missile Command: Recharged,2022-11-01,4,9,1,10,70.57,0
Missile Command: Recharged,2020-05-27,9,161,19,180,81.2,1
Missile Command: Recharged,2020-05-27,9,161,19,180,81.2,0
Arcane Arts Academy 2,2022-09-22,6,9,1,10,70.57,0
Korean BBQ Simulator,2022-10-14,2,9,1,10,70.57,0
VR Rock Climbing,2022-09-28,2,9,1,10,70.57,0
STRAY CAT,2022-10-01,2,9,1,10,70.57,0
Ankora: Lost Days - Prologue,2022-10-28,4,9,1,10,70.57,0
Hoiwa Hub,2022-10-15,2,9,1,10,70.57,0
Each Other,2022-10-31,3,9,1,10,70.57,0
Dark Sweeper,2022-11-17,4,9,1,10,70.57,0
Palladise Island：Legendary Space,2022-12-08,6,9,1,10,70.57,0
I commissioned some bees (advent),2022-12-01,6,9,1,10,70.57,0
Истории ужасов: Воскрешение,2022-02-19,23,113,35,148,70.51,0
Engine Evolution 2021,2022-01-12,158,529,188,717,70.5,1
Arctico,2022-02-15,132,826,301,1127,70.48,0
De'Vine: Heavenly Acres,2022-07-29,13,23,5,28,70.48,0
SUPER NANARU,2022-03-24,6,23,5,28,70.48,0
Stardust Valkyries,2022-09-15,15,23,5,28,70.48,0
Divinus Vanitas,2022-09-14,6,23,5,28,70.48,0
Fairy Girl,2022-11-11,5,23,5,28,70.48,0
The Pegasus Expedition,2022-10-20,123,66,19,85,70.41,2
ERRANTE,2022-02-04,18,48,13,61,70.41,0
Tuin,2022-08-26,46,54,15,69,70.39,2
Weird Hat Fight,2022-05-16,90,26,6,32,70.34,0
Riki's Risky Ride,2022-03-15,14,26,6,32,70.34,0
VaporBall,2022-03-02,6,16,3,19,70.33,0
Revenants,2022-10-27,3,16,3,19,70.33,0
Brave Deeds of Rescue Team,2022-06-08,25,16,3,19,70.33,0
Automation,2022-01-24,6,16,3,19,70.33,0
Grandma's Footsteps,2022-02-22,4,16,3,19,70.33,0
The House On Holland Hill,2022-03-01,2,16,3,19,70.33,0
Avocado Love,2022-01-17,12,16,3,19,70.33,0
Furry Boys Jigsaw,2022-01-24,3,16,3,19,70.33,0
HardWorker Simulator,2022-02-18,7,16,3,19,70.33,0
Shadow Running,2022-01-31,5,16,3,19,70.33,0
Monsterlands,2022-06-14,10,16,3,19,70.33,0
STEIIARIA,2022-06-25,2,16,3,19,70.33,0
SEARCH ALL - BITCOIN,2022-06-12,3,16,3,19,70.33,0
The Last Fighter,2022-07-30,3,16,3,19,70.33,0
Big Bad Futanari Wolf,2022-12-15,5,16,3,19,70.33,0
Missing Pieces,2022-10-19,5,16,3,19,70.33,0
Super Clown 3: Revenge,2022-11-08,4,16,3,19,70.33,0
IN THE BUILDING: CATS 2,2022-12-19,6,16,3,19,70.33,0
CRIMESIGHT,2022-04-14,572,484,173,657,70.31,0
Voice of Chernobyl,2022-09-18,666,80,24,104,70.29,4
Handyman Corporation: Prologue,2022-12-16,574,117,37,154,70.28,1
Spiders Everywhere,2022-01-22,24,97,30,127,70.26,0
The Adventures of Poppe,2022-08-05,5,29,7,36,70.25,0
Harem of Nurses,2022-07-15,48,71,21,92,70.23,1
Master of Magic,2022-12-13,1028,489,176,665,70.21,159
Black Hole Pool,2022-08-02,44,65,19,84,70.19,0
Take the Throne,2022-04-20,153,119,38,157,70.18,0
风色幻想3:罪与罚的镇魂歌,2022-08-09,138,85,26,111,70.16,1
Ancient Wars: Sparta Definitive Edition,2022-01-28,44,163,54,217,70.15,15
Letina's Odyssey,2022-09-17,85,35,9,44,70.15,0
Vanaris Tactics - Prologue,2022-04-21,10,35,9,44,70.15,0
TimeMelters - Challenges,2022-08-04,11,35,9,44,70.15,0
Reborn,2022-10-28,37,35,9,44,70.15,2
Hentai Furry 3,2022-08-24,6,35,9,44,70.15,0
Survival Academy,2022-11-08,57,56,16,72,70.14,1
The Triumphant Return of Diabolos,2022-06-11,124,41,11,52,70.12,4
My Pet Sitter is a Futanari,2022-05-27,5,41,11,52,70.12,0
Secrets of the Temple,2022-03-14,8,41,11,52,70.12,0
Garfield Lasagna Party,2022-11-10,12,41,11,52,70.12,1
Firelight Fantasy: Force Energy,2022-02-18,7,44,12,56,70.11,0
Little Orpheus,2022-09-13,49,157,52,209,70.1,4
Nero The Sniper,2022-07-22,59,124,40,164,70.1,1
Space Roguelike Adventure,2022-10-11,6,19,4,23,70.08,0
Hatsumira -from the future undying-,2022-04-28,37,19,4,23,70.08,0
Soul In the Chamber,2022-04-25,5,19,4,23,70.08,0
Under The Moon,2022-12-06,9,19,4,23,70.08,0
SIMBA THE CAT,2022-06-24,3,19,4,23,70.08,0
Age of Solitaire : Build Civilization,2022-07-27,9,19,4,23,70.08,1
THE FATE OF MIRADOR CHAPTER ONE,2022-07-23,14,19,4,23,70.08,2
Coin Pusher Casino,2022-12-28,35,19,4,23,70.08,3
Emma - In the Library,2022-12-01,6,19,4,23,70.08,0
A Sinful Camp,2022-02-15,92,173,58,231,70.06,3
My Museum Prologue: Treasure Hunter,2022-09-16,153,118,38,156,70.04,0
Demon Sword: Incubus,2022-06-17,89,90,28,118,70.04,2
Halftime Heroes,2022-03-11,388,197,67,264,70.03,0
Ultrawings 2,2022-10-27,25,67,20,87,69.99,1
Colony Simulator,2022-02-08,92,247,86,333,69.97,4
精靈之妊 -用懷孕征服所有傲慢的精靈-,2022-11-16,452,247,86,333,69.97,2
Vostok 2061,2022-10-07,7,22,5,27,69.94,0
DreamBig 3,2022-03-31,4,22,5,27,69.94,0
PISTOLA,2022-06-21,7,22,5,27,69.94,0
Animals Transport Simulator,2022-05-26,2,22,5,27,69.94,0
Be My Girlfriends,2022-04-13,167,278,98,376,69.92,0
Black Geyser: Couriers of Darkness,2022-03-17,330,527,194,721,69.91,23
My Loving Wife,2022-12-06,9,58,17,75,69.91,0
Fightto the last,2022-11-28,4,12,2,14,69.91,0
Essence Of The Tjikko - Prologue,2022-02-02,4,12,2,14,69.91,0
Tower of the sage,2022-07-28,3,12,2,14,69.91,0
Kamigami: Clash of the Gods,2022-07-25,7,12,2,14,69.91,0
Haunted Hotel: Silent Waters Collector's Edition,2022-01-07,13,12,2,14,69.91,1
SAVE BILLY,2022-01-24,4,12,2,14,69.91,0
Blastocitos,2022-03-02,4,12,2,14,69.91,0
Frog Fall Down,2022-03-08,4,12,2,14,69.91,0
Night Blood : Avenger's Tide,2022-07-11,4,12,2,14,69.91,0
Sex Adventures - Mile High Club,2022-03-04,5,12,2,14,69.91,0
Alexandria - Port of Worlds,2022-05-14,8,12,2,14,69.91,0
Space egg shooter,2022-05-06,3,12,2,14,69.91,0
Mount Wingsuit 2,2022-08-25,4,12,2,14,69.91,0
Lander Odyssey,2022-05-17,5,12,2,14,69.91,0
Cryptr,2022-08-31,2,12,2,14,69.91,0
Flora and Sauna,2022-06-06,9,12,2,14,69.91,0
Ancient Aliens,2022-09-28,11,12,2,14,69.91,7
Penguins Can Fly,2022-07-19,5,12,2,14,69.91,0
Hero of war,2022-09-01,2,12,2,14,69.91,0
Bots City,2022-07-11,2,12,2,14,69.91,0
SUN SHOT,2022-09-03,2,12,2,14,69.91,0
The Letter: Classic Edition,2022-11-08,2,12,2,14,69.91,0
Virtual Sailor NG,2022-10-06,18,12,2,14,69.91,8
Blood Exile,2022-11-21,1,12,2,14,69.91,0
Gravity Magician,2022-11-19,3,12,2,14,69.91,0
ZAVOD,2022-12-26,5,12,2,14,69.91,0
LOST EPIC,2022-07-27,1175,705,264,969,69.88,11
Prosperous Universe,2022-04-20,183,361,130,491,69.88,28
Siren Head: The Horror Experience,2022-11-23,37,144,48,192,69.87,3
Vanaris Tactics,2022-08-04,47,89,28,117,69.87,0
Achilles: Legends Untold,2022-05-12,266,345,124,469,69.86,2
Holomento,2022-04-27,93,100,32,132,69.85,2
Charon's Staircase,2022-10-28,8,25,6,31,69.85,0
My Nemesis and Hero,2022-01-11,6,25,6,31,69.85,0
Sword of Atlas,2022-04-27,6,25,6,31,69.85,0
Lawnmower game: Mortal Race,2022-06-01,6,25,6,31,69.85,0
Save Daddy Trump 3: Rise Of Evil,2022-09-01,6,25,6,31,69.85,0
Ballads and Romances,2022-12-21,4,25,6,31,69.85,0
Zoey: My Hentai Sex Doll,2022-09-09,43,111,36,147,69.84,0
The Backroom Project,2022-05-15,9,97,31,128,69.81,0
Monorail Stories,2022-09-30,16,28,7,35,69.8,0
The Dark Prophecy,2022-02-28,4,28,7,35,69.8,0
Lustful Pussies,2022-06-01,2,28,7,35,69.8,0
绯色物语,2022-10-28,23,28,7,35,69.8,0
Star Melody Yumemi Dreamer,2022-01-21,18,43,12,55,69.79,0
Tennis Manager 2022,2022-05-17,277,94,30,124,69.77,50
RTX Sweeper,2022-03-17,10,37,10,47,69.77,2
ConflictCraft 2,2022-02-10,7,37,10,47,69.77,1
Rogue Arrows,2022-06-06,44,31,8,39,69.77,0
Idle Superpowers,2022-01-05,149,31,8,39,69.77,8
生人症候群,2022-05-09,4,31,8,39,69.77,0
Infiltraliens,2022-01-13,14,34,9,43,69.76,0
Will Die Alone,2022-05-20,5,34,9,43,69.76,0
Lustful Ponies,2022-04-11,6,34,9,43,69.76,0
Beautiful Mystic Survivors,2022-10-14,1461,730,276,1006,69.75,5
Desktop Girlfriend,2022-08-24,392,530,197,727,69.75,2
守护女神,2022-11-11,181,175,60,235,69.74,11
LakeSide,2022-09-28,93,77,24,101,69.72,1
Bakery Simulator,2022-05-03,428,539,201,740,69.71,36
Heads Will Roll: Downfall,2022-10-20,447,217,76,293,69.71,2
Frozenheim,2022-06-16,2523,2025,800,2825,69.7,119
Ed-0: Zombie Uprising,2022-04-04,113,82,26,108,69.61,2
Stardust Origins,2022-02-02,4,15,3,18,69.59,0
Project Dagger,2022-07-25,5,15,3,18,69.59,0
Storyblocks: The King,2022-01-24,3,15,3,18,69.59,0
Just in Slime,2022-03-01,8,15,3,18,69.59,0
Semiconductor,2022-05-20,5,15,3,18,69.59,0
DEAD GUN,2022-02-03,4,15,3,18,69.59,0
Instant Artist: Puzzle Mashup,2022-03-17,5,15,3,18,69.59,0
Pretty Girls Four Kings Solitaire,2022-03-18,9,15,3,18,69.59,0
Elemental Angel Ⅱ,2022-03-17,3,15,3,18,69.59,0
2D Brick Breaker Game | REMASTERED,2022-07-05,5,15,3,18,69.59,0
Cowboy Girl,2022-07-08,2,15,3,18,69.59,0
Night Gate,2022-10-14,5,15,3,18,69.59,0
Midnight Saga: The Monster,2022-10-06,26,15,3,18,69.59,0
Dark Maidens,2022-11-02,5,15,3,18,69.59,0
Cookie Clicker But You Type,2022-09-13,5,15,3,18,69.59,0
Space Runaway,2022-12-22,12,15,3,18,69.59,0
Weird Japan,2022-09-23,6,15,3,18,69.59,0
The Exorcist's Story,2022-11-11,7,15,3,18,69.59,0
3D Lover,2022-03-08,13,79,25,104,69.57,0
Pumping Simulator,2022-04-06,78,256,92,348,69.52,16
Hell is Others,2022-10-20,942,708,271,979,69.51,32
Movie Night,2022-01-27,91,217,77,294,69.51,1
Estella's Nightmare: Sealed Space and a Succubus's Curse,2022-08-09,125,266,96,362,69.5,1
Golden Axe Idol,2022-07-15,50,45,13,58,69.5,0
Eternal Edge,2022-05-08,68,327,120,447,69.47,2
AccrO,2022-05-24,3,42,12,54,69.46,1
One True Hero,2022-10-20,4,18,4,22,69.44,0
Grimstar: Welcome to the savage planet,2022-10-26,7,18,4,22,69.44,0
Funny Panda,2022-02-09,3,18,4,22,69.44,0
1000 Needles,2022-02-11,7,18,4,22,69.44,0
The Conqueror of Battles,2022-03-25,8,18,4,22,69.44,0
WONDER POT - Texas Holdem,2022-05-18,18,18,4,22,69.44,0
The World of a Mermaid,2022-06-01,2,18,4,22,69.44,0
Monster Showdown Prologue,2022-06-17,15,18,4,22,69.44,1
Riding Away,2022-05-18,1,8,1,9,69.44,0
Invasion Vill,2022-05-31,2,8,1,9,69.44,0
Fake Racing,2022-06-23,2,8,1,9,69.44,0
Worshippers Of The Gain,2022-03-01,9,8,1,9,69.44,0
Rift World,2022-02-12,3,8,1,9,69.44,0
Azrael,2022-05-17,3,8,1,9,69.44,0
Azrael,2022-05-17,3,8,1,9,69.44,0
Azrael,2022-05-17,3,8,1,9,69.44,0
Azrael,2022-07-22,2,6,2,8,62.1,0
Azrael,2022-07-22,2,6,2,8,62.1,0
Azrael,2022-07-22,2,6,2,8,62.1,0
Azrael,2022-03-07,3,6,3,9,58.33,0
Azrael,2022-03-07,3,6,3,9,58.33,0
Azrael,2022-03-07,3,6,3,9,58.33,0
Find the Cats,2022-07-29,3,8,1,9,69.44,0
DC League of Super-Pets: The Adventures of Krypto and Ace,2022-07-15,3,8,1,9,69.44,0
Dark Tales from México: Prelude. Just a Dream... with The Sack Man,2022-10-25,3,8,1,9,69.44,0
Tarot: Theo's Quest,2022-05-25,3,8,1,9,69.44,0
Tigey's Gift,2022-04-28,2,8,1,9,69.44,0
ARTISAN,2022-02-03,4,8,1,9,69.44,0
Blink Planets,2022-01-13,6,8,1,9,69.44,0
Lovely Girls,2022-01-06,3,8,1,9,69.44,0
Nova Odessa - The Demon Trainer,2022-06-02,5,8,1,9,69.44,0
Great Deer,2022-04-21,5,8,1,9,69.44,1
Slime Village VR,2022-01-24,4,8,1,9,69.44,0
Vortex,2022-06-23,1,8,1,9,69.44,0
Vortex,2022-06-23,1,8,1,9,69.44,0
Vortex,2022-06-23,1,8,1,9,69.44,0
Vortex,2021-09-09,1,2,0,2,64.08,0
Vortex,2021-09-09,1,2,0,2,64.08,0
Vortex,2021-09-09,1,2,0,2,64.08,0
Vortex,2015-07-17,2,2,8,10,34.58,0
Vortex,2015-07-17,2,2,8,10,34.58,0
Vortex,2015-07-17,2,2,8,10,34.58,0
Who Shuffled My Shapes?,2022-07-08,3,8,1,9,69.44,0
NecroFarm,2022-03-25,2,8,1,9,69.44,0
A Tale About Flowers,2022-02-04,3,8,1,9,69.44,0
PATIENT,2022-06-01,2,8,1,9,69.44,0
Vonbit,2022-03-31,3,8,1,9,69.44,0
Aces Under the Moonlight,2022-06-03,3,8,1,9,69.44,0
Underground Dungeon,2022-03-09,4,8,1,9,69.44,0
Magnetic Structures,2022-10-18,2,8,1,9,69.44,0
Freshman Magic: Spellbooks and Tangled Sheets,2022-05-26,21,8,1,9,69.44,0
Royal Duality,2022-08-29,6,8,1,9,69.44,0
Erroneous,2022-06-01,5,8,1,9,69.44,0
Ultimate Obstacle Course,2022-05-16,6,8,1,9,69.44,0
Trade Sails,2022-05-19,2,8,1,9,69.44,0
RPG BOYS FANTASY,2022-06-16,3,8,1,9,69.44,0
Intrusion of Alice,2022-10-28,10,8,1,9,69.44,0
Spermination: Cream of the Crop,2022-07-15,4,8,1,9,69.44,0
Youmandriver,2022-06-28,3,8,1,9,69.44,0
Long Drop,2022-12-02,4,8,1,9,69.44,0
Special Gulag Rescue Operation,2022-07-07,2,8,1,9,69.44,0
Terror Brain: Night Out,2022-09-25,3,8,1,9,69.44,0
Unichrome: a 1-Bit Unicorn Adventure,2022-09-16,3,8,1,9,69.44,0
Astra Protocol 2,2022-12-01,3,8,1,9,69.44,0
미연시 시뮬레이터 : 미소녀 게임의 주인공을 조종하는 게임,2022-07-21,3,8,1,9,69.44,0
Eris and the fading kingdom,2022-07-22,3,8,1,9,69.44,0
Goblin Rules Football,2022-10-20,6,8,1,9,69.44,0
Battle Part,2022-07-21,9,8,1,9,69.44,0
Humans Are Useless,2022-07-28,3,8,1,9,69.44,0
Neon Fighter,2022-08-09,4,8,1,9,69.44,0
Where's the Bathroom!?!,2022-09-09,2,8,1,9,69.44,0
Nude Crisis,2022-08-10,3,8,1,9,69.44,0
Western Girls,2022-08-27,2,8,1,9,69.44,0
Mythlands: Dragon Flight VR,2022-08-31,2,8,1,9,69.44,0
Droneboi 2,2022-09-10,5,8,1,9,69.44,0
Hikki Girls,2022-08-27,2,8,1,9,69.44,0
Slurpies FREE,2022-12-02,2,8,1,9,69.44,0
Soldier,2022-09-01,1,8,1,9,69.44,0
Paragonian 3 : The Warrior of Light,2022-11-08,3,8,1,9,69.44,0
Eraser,2022-10-24,7,8,1,9,69.44,0
Eraser,2022-10-24,7,8,1,9,69.44,3
Eraser,2021-12-15,195,1932,335,2267,81.78,0
Eraser,2021-12-15,195,1932,335,2267,81.78,3
Devolution 魔剣の王としもべたち,2022-09-29,6,8,1,9,69.44,0
DEATHWATCH - PRELUDE,2022-10-20,9,8,1,9,69.44,0
Hot Milf 9,2022-10-30,2,8,1,9,69.44,0
The Slothgate Experiment,2022-12-17,3,8,1,9,69.44,0
Bubbles Swimsuit,2022-11-01,2,8,1,9,69.44,0
Doughball Descent,2022-11-30,13,8,1,9,69.44,0
Undercover - Blood Bonds,2022-11-17,8,8,1,9,69.44,1
クラウディ・デイズ,2022-12-22,6,8,1,9,69.44,0
1 Day Later: Escape Zombie Hospital,2022-12-02,2,8,1,9,69.44,0
Space Mercenary Defense Force,2022-12-16,3,8,1,9,69.44,0
Holiday Haywire,2022-12-31,17,8,1,9,69.44,0
Live by the Sword: Tactics,2022-10-28,10,39,11,50,69.43,0
ESPIONAGE: Mafia Evolved,2022-08-12,61,81,26,107,69.42,1
Do You See the Waving Cape,2022-06-03,4,36,10,46,69.39,0
Crafting Town,2022-07-28,11,36,10,46,69.39,0
For The Warp,2022-03-28,123,246,89,335,69.37,4
Zold:out 鍛造屋的物語,2022-11-30,650,158,55,213,69.37,32
Cursed Treasure 2 Ultimate Edition,2022-07-14,110,97,32,129,69.37,8
Showbiz Tycoon,2022-02-25,10,33,9,42,69.36,3
Night Signal,2022-11-07,4,21,5,26,69.36,0
Aegis Descent,2022-07-08,14,21,5,26,69.36,1
Forsaken Portals,2022-08-07,8,21,5,26,69.36,0
Ash & Rust,2022-04-01,9,21,5,26,69.36,0
M1 Tank Platoon II,2022-05-04,5,21,5,26,69.36,0
Cascade Tactics,2022-02-17,11,21,5,26,69.36,0
Skeletal Skism,2022-01-04,10,21,5,26,69.36,0
Aery - Dreamscape,2022-01-14,7,21,5,26,69.36,0
World of Mines Creator's Edition,2022-05-10,7,21,5,26,69.36,0
Still Heroes,2022-04-22,3,21,5,26,69.36,0
The Tales of Imjin War,2022-11-30,12,21,5,26,69.36,0
Aristocunts II Re:ERECTION,2022-07-22,15,21,5,26,69.36,1
NoAmmo,2022-08-05,3,21,5,26,69.36,0
The Demon Within Me,2022-10-25,4,21,5,26,69.36,0
JaDa Fishin',2022-10-26,4,21,5,26,69.36,0
HOTEL GREENWOOD,2022-08-10,10,86,28,114,69.34,0
Unyielding,2022-09-22,29,30,8,38,69.34,0
Monster Showdown,2022-01-27,6,27,7,34,69.33,0
Mountain Offroad Simulator,2022-07-18,4,27,7,34,69.33,0
Empire of Empires,2022-07-29,2,27,7,34,69.33,0
Trails of the Black Sun,2022-10-04,3,24,6,30,69.33,0
REPTRAILS,2022-06-17,10,24,6,30,69.33,0
Witch Strandings,2022-07-07,30,24,6,30,69.33,0
Seeking Light,2022-07-27,7,24,6,30,69.33,0
Vermis Orbita,2022-07-29,5,24,6,30,69.33,0
Argentum Online Forever (AOF),2022-10-04,39,24,6,30,69.33,6
Shovel Knight Dig,2022-09-23,800,440,166,606,69.32,22
捕鱼王国Fishing Kingdom,2022-04-05,33,75,24,99,69.32,0
Kilta,2022-07-10,21,50,15,65,69.3,4
Those Who Crawl,2022-12-26,12,72,23,95,69.26,0
Trek to Yomi,2022-05-05,855,1037,410,1447,69.24,8
THE HOUSE OF THE DEAD: Remake,2022-04-28,505,937,369,1306,69.24,4
Blue Fire: Void Maker,2022-02-04,23,47,14,61,69.24,0
beat refle,2022-07-31,455,141,49,190,69.23,1
LEGO® Brawls,2022-09-02,85,96,32,128,69.21,8
Pursuit of Power 2 : The Chaos Dimension,2022-10-26,4,4,0,4,69.2,0
Tank Tactics,2022-04-02,3,4,0,4,69.2,0
VRpatients,2022-02-09,6,4,0,4,69.2,0
Cahertis,2022-08-16,5,4,0,4,69.2,0
Pharao Reloaded,2022-08-01,4,4,0,4,69.2,0
As Aventuras do Cueca Listrada,2022-07-12,2,4,0,4,69.2,0
The Ancient Art of Staying Alive,2022-01-19,1,4,0,4,69.2,0
Ryclaw: Hope,2022-10-05,1,4,0,4,69.2,0
Voyager,2022-01-14,3,4,0,4,69.2,0
One Drunken Knight,2022-11-23,2,4,0,4,69.2,0
Quester,2022-06-23,4,4,0,4,69.2,0
Mickey Storm and the Cursed Mask,2022-04-29,3,4,0,4,69.2,0
warDrive,2022-04-01,6,4,0,4,69.2,0
Vesper: Ether Saga,2022-08-16,4,4,0,4,69.2,0
Puzzle Box,2022-01-30,3,4,0,4,69.2,0
Puzzle Box,2022-01-30,3,4,0,4,69.2,1
Puzzle Box,2022-01-30,3,4,0,4,69.2,0
Puzzle Box,2021-08-24,3,4,0,4,69.2,0
Puzzle Box,2021-08-24,3,4,0,4,69.2,1
Puzzle Box,2021-08-24,3,4,0,4,69.2,0
Puzzle Box,2016-04-22,13,27,6,33,70.81,0
Puzzle Box,2016-04-22,13,27,6,33,70.81,1
Puzzle Box,2016-04-22,13,27,6,33,70.81,0
Orbi's chronicles,2022-02-08,4,4,0,4,69.2,0
Spellbound : The Magic Within,2022-09-02,4,4,0,4,69.2,0
Agent Roswell : Tactics,2022-04-01,3,4,0,4,69.2,0
Mollycoddle Mayhem,2022-07-14,5,4,0,4,69.2,0
Sonucido: The Mage,2022-12-02,2,4,0,4,69.2,0
Shooty,2022-01-12,2,4,0,4,69.2,0
Shooty,2022-01-12,2,4,0,4,69.2,0
Shooty,2021-07-07,3,7,5,12,54.48,0
Shooty,2021-07-07,3,7,5,12,54.48,0
Dialogue Box: The Road Less Traveled,2022-04-28,3,4,0,4,69.2,0
ShapeVS,2022-09-29,7,4,0,4,69.2,0
AbyssMemory,2022-04-27,7,4,0,4,69.2,0
Re-Spawn Tournament,2022-09-01,8,4,0,4,69.2,0
Magic Exposure – Yuri Visual Novel,2022-12-09,3,4,0,4,69.2,0
Keep It Live,2022-04-08,6,4,0,4,69.2,0
Anyway,2022-02-22,2,4,0,4,69.2,0
Cube,2022-03-05,2,4,0,4,69.2,0
Cube,2022-03-05,2,4,0,4,69.2,0
Cube,2022-03-05,2,4,0,4,69.2,0
Cube,2021-09-12,1,2,0,2,64.08,0
Cube,2021-09-12,1,2,0,2,64.08,0
Cube,2021-09-12,1,2,0,2,64.08,0
Cube,2020-03-08,1,1,0,1,59.42,0
Cube,2020-03-08,1,1,0,1,59.42,0
Cube,2020-03-08,1,1,0,1,59.42,0
Solitaire Bonbon,2022-03-01,4,4,0,4,69.2,0
The Case of Maneki,2022-03-21,2,4,0,4,69.2,0
ANIQUILATION,2022-07-29,3,4,0,4,69.2,0
Metal and Hauling RPG Simulator,2022-01-07,2,4,0,4,69.2,0
Book of Adventum,2022-02-18,3,4,0,4,69.2,0
Redux,2022-02-11,2,4,0,4,69.2,0
Crystalreach Islands,2022-11-09,4,4,0,4,69.2,0
Highway Rampage,2022-08-29,2,4,0,4,69.2,0
Platformer::Execute();,2022-08-16,4,4,0,4,69.2,0
Cube Runk,2022-02-25,2,4,0,4,69.2,0
Dann Fox & The Time Machine,2022-08-17,1,4,0,4,69.2,0
UC SIM ～unity-chan simulator～,2022-02-28,2,4,0,4,69.2,0
Pirates of Gravitae,2022-03-31,3,4,0,4,69.2,0
Inferno,2022-04-29,3,4,0,4,69.2,0
Inferno,2022-04-29,3,4,0,4,69.2,0
Inferno,2020-10-01,1129,11,4,15,63.21,0
Inferno,2020-10-01,1129,11,4,15,63.21,0
Dogfight: 80 Years of Aerial Warfare,2022-01-21,2,4,0,4,69.2,0
Super Liquid Soccer,2022-11-30,2,4,0,4,69.2,0
Sumo Seals,2022-10-22,3,4,0,4,69.2,0
CAPTAIN STARONE,2022-10-20,20,4,0,4,69.2,0
Dyflexion,2022-03-09,2,4,0,4,69.2,0
Chameleon - DYH,2022-07-25,4,4,0,4,69.2,0
Fira,2022-07-15,2,4,0,4,69.2,0
Reed The Robotanist Plus,2022-08-18,2,4,0,4,69.2,0
Hymns of Resurrection,2022-02-11,4,4,0,4,69.2,0
Pocket Rocket PC,2022-01-16,3,4,0,4,69.2,0
Press D to Die,2022-08-07,3,4,0,4,69.2,0
The Song Out of Space,2022-02-04,2,4,0,4,69.2,0
Drunken Fist 2: Zombie Hangover,2022-06-22,2,4,0,4,69.2,0
The Video Game Machine,2022-11-08,3,4,0,4,69.2,0
Gruta: Prologue of the Gloomy Whispers,2022-12-24,2,4,0,4,69.2,0
蛋-腾,2022-02-04,1,4,0,4,69.2,0
Momo's Mansion,2022-02-14,2,4,0,4,69.2,0
青鳥樂園 Blue Bird Land EP.2 下篇,2022-10-25,2,4,0,4,69.2,0
The Dead Prince,2022-10-17,3,4,0,4,69.2,0
Short Circuit,2022-02-17,3,4,0,4,69.2,0
Stretchy-Man: The Video Game,2022-03-31,2,4,0,4,69.2,0
Praecantor Lila ~ Bell Spell,2022-03-12,3,4,0,4,69.2,0
Graveyard Spells,2022-01-12,1,4,0,4,69.2,0
Bounce Ball: Neon Party Arcade,2022-02-04,4,4,0,4,69.2,0
The Pest,2022-05-18,2,4,0,4,69.2,1
Save the Llama,2022-04-22,4,4,0,4,69.2,0
GoKart - NewMexico,2022-02-17,3,4,0,4,69.2,0
Invisible Crush,2022-05-16,3,4,0,4,69.2,0
Amshay,2022-05-09,2,4,0,4,69.2,0
Conveyance,2022-01-31,3,4,0,4,69.2,0
Snakepit Larry,2022-01-02,1,4,0,4,69.2,0
Re;quartz零度,2022-08-12,2,4,0,4,69.2,0
Note of Janus,2022-08-05,5,4,0,4,69.2,0
Cannon Canines,2022-08-22,4,4,0,4,69.2,0
OtterQuest,2022-01-31,1,4,0,4,69.2,0
DRAGON NINJA BYOKA,2022-05-05,2,4,0,4,69.2,0
Pixa Clicker,2022-07-29,3,4,0,4,69.2,0
Ryclaw: Save Yourself,2022-01-21,1,4,0,4,69.2,0
White,2022-12-21,2,4,0,4,69.2,0
armageddon war: old era wreckers,2022-05-06,4,4,0,4,69.2,0
生還者日,2022-03-22,3,4,0,4,69.2,0
Circuit: Laser Maze,2022-03-01,2,4,0,4,69.2,0
Tactical Recon,2022-10-03,3,4,0,4,69.2,0
Labyrinth deLux - A Crusoe Quest,2022-03-02,2,4,0,4,69.2,0
Escape Purgatory,2022-10-22,3,4,0,4,69.2,0
I Am Gangster,2022-03-18,2,4,0,4,69.2,0
Spirits Chronicles: Born in Flames Collector's Edition,2022-02-08,6,4,0,4,69.2,0
The House of Big people,2022-02-02,1,4,0,4,69.2,0
滴答,2022-04-06,1,4,0,4,69.2,0
My Kindergarten Learning Adventure,2022-03-13,3,4,0,4,69.2,0
Explosion™,2022-06-30,2,4,0,4,69.2,0
Maze: Pedestal of Trials,2022-06-23,2,4,0,4,69.2,0
Jumpy Ball Happy Fun Time,2022-02-16,2,4,0,4,69.2,0
Coins Chests and Loot,2022-02-17,3,4,0,4,69.2,1
Nova Slash: Unparalleled Power,2022-03-24,2,4,0,4,69.2,0
Radio Free Europa,2022-04-22,4,4,0,4,69.2,0
Blob Boy,2022-03-04,4,4,0,4,69.2,0
Aster Force,2022-04-04,2,4,0,4,69.2,0
Escape To School,2022-03-07,1,4,0,4,69.2,0
Wordies,2022-03-01,3,4,0,4,69.2,0
Roly Poly,2022-04-19,3,4,0,4,69.2,0
Polychromia,2022-05-31,3,4,0,4,69.2,0
COPS 2170,2022-06-10,2,4,0,4,69.2,0
SpectrumGames,2022-03-21,7,4,0,4,69.2,0
Ball Pain,2022-03-14,2,4,0,4,69.2,0
DreamPusher,2022-03-16,5,4,0,4,69.2,0
Psycho Crab,2022-03-29,3,4,0,4,69.2,0
cyVeRpunk,2022-09-01,1,4,0,4,69.2,0
LAB,2022-05-11,3,4,0,4,69.2,0
GlassBox,2022-04-12,2,4,0,4,69.2,0
Adventures of Samuel: The Worst Game Ever Made,2022-03-23,1,4,0,4,69.2,0
Die Die Die And Try,2022-04-04,4,4,0,4,69.2,0
Planet Conqueror,2022-04-08,2,4,0,4,69.2,0
Stoney's Adventure,2022-12-26,2,4,0,4,69.2,0
Dickie A Cumming: The Prequel (Part I),2022-04-21,2,4,0,4,69.2,0
Mirages of Winter,2022-11-22,2,4,0,4,69.2,0
Shape Puzzle,2022-07-16,2,4,0,4,69.2,0
鸟兽幻戏图 Bird and Beast Fantasy,2022-04-07,2,4,0,4,69.2,0
The Horror Story: Remastered - The Prequel,2022-05-18,2,4,0,4,69.2,0
Vacation Adventures: Park Ranger 13,2022-04-28,6,4,0,4,69.2,1
All Alone with Mannie,2022-06-02,2,4,0,4,69.2,0
PIPIISYOU,2022-04-15,2,4,0,4,69.2,0
Other,2022-06-24,4,4,0,4,69.2,0
bluem,2022-05-06,2,4,0,4,69.2,0
TERROVOX,2022-05-04,2,4,0,4,69.2,0
Scandal Notes,2022-12-01,15,4,0,4,69.2,0
River Rush,2022-05-03,3,4,0,4,69.2,0
Elemental Angel Ⅲ,2022-06-17,2,4,0,4,69.2,0
WFO World Football Online,2022-09-12,3,4,0,4,69.2,0
Curro,2022-05-21,2,4,0,4,69.2,0
Food Fight,2022-05-03,2,4,0,4,69.2,0
Spell Welders,2022-05-06,4,4,0,4,69.2,0
Purrate Adventure: Volcano Isle,2022-05-12,2,4,0,4,69.2,0
tiltfire,2022-11-14,3,4,0,4,69.2,0
Dominate - Board Game,2022-09-14,2,4,0,4,69.2,0
MazezaM - Puzzle Game,2022-07-05,1,4,0,4,69.2,0
Alone,2022-07-22,5,4,0,4,69.2,0
Alone,2022-07-22,5,4,0,4,69.2,0
Alone,2022-07-22,5,4,0,4,69.2,0
Alone,2022-07-22,5,4,0,4,69.2,0
Alone,2022-07-22,5,4,0,4,69.2,0
Alone,2022-07-22,5,4,0,4,69.2,0
Alone,2021-09-24,4,4,0,4,69.2,0
Alone,2021-09-24,4,4,0,4,69.2,0
Alone,2021-09-24,4,4,0,4,69.2,0
Alone,2021-09-24,4,4,0,4,69.2,0
Alone,2021-09-24,4,4,0,4,69.2,0
Alone,2021-09-24,4,4,0,4,69.2,0
Alone,2021-07-30,2,0,1,1,40.58,0
Alone,2021-07-30,2,0,1,1,40.58,0
Alone,2021-07-30,2,0,1,1,40.58,0
Alone,2021-07-30,2,0,1,1,40.58,0
Alone,2021-07-30,2,0,1,1,40.58,0
Alone,2021-07-30,2,0,1,1,40.58,0
Alone,2021-11-11,2,0,1,1,40.58,0
Alone,2021-11-11,2,0,1,1,40.58,0
Alone,2021-11-11,2,0,1,1,40.58,0
Alone,2021-11-11,2,0,1,1,40.58,0
Alone,2021-11-11,2,0,1,1,40.58,0
Alone,2021-11-11,2,0,1,1,40.58,0
Alone,2018-05-01,3,18,6,24,65.51,0
Alone,2018-05-01,3,18,6,24,65.51,0
Alone,2018-05-01,3,18,6,24,65.51,0
Alone,2018-05-01,3,18,6,24,65.51,0
Alone,2018-05-01,3,18,6,24,65.51,0
Alone,2018-05-01,3,18,6,24,65.51,0
Alone,2018-06-21,5,23,14,37,58.09,0
Alone,2018-06-21,5,23,14,37,58.09,0
Alone,2018-06-21,5,23,14,37,58.09,0
Alone,2018-06-21,5,23,14,37,58.09,0
Alone,2018-06-21,5,23,14,37,58.09,0
Alone,2018-06-21,5,23,14,37,58.09,0
Dreams of Pain,2022-11-11,3,4,0,4,69.2,0
Super Indiemania,2022-11-02,2,4,0,4,69.2,0
Coalescence,2022-09-30,3,4,0,4,69.2,0
Spacewing War,2022-06-08,2,4,0,4,69.2,0
Palmas,2022-05-18,3,4,0,4,69.2,0
Chromatic,2022-05-20,2,4,0,4,69.2,0
Chromatic,2022-05-20,2,4,0,4,69.2,0
Chromatic,2017-07-17,15,20,3,23,72.76,0
Chromatic,2017-07-17,15,20,3,23,72.76,0
Grizelda: Lynx and the Nine Lives,2022-10-06,4,4,0,4,69.2,0
Knights of the Exploding Table,2022-05-29,4,4,0,4,69.2,0
The Trials Of Beadie,2022-09-23,2,4,0,4,69.2,0
Tiny Arcade Racers,2022-05-20,2,4,0,4,69.2,0
Eschew,2022-06-12,2,4,0,4,69.2,0
Breakyo,2022-07-25,3,4,0,4,69.2,0
Keita's Adventures on the African Savannah,2022-06-12,2,4,0,4,69.2,0
♡beAt! -After the Summer-,2022-08-09,2,4,0,4,69.2,0
Elohim Eternal - Prologue,2022-07-13,3,4,0,4,69.2,0
我感染HIV了吗,2022-06-20,1,4,0,4,69.2,0
Martial Story,2022-06-09,1,4,0,4,69.2,0
Roomli,2022-06-10,3,4,0,4,69.2,0
Dis Pontibus 2,2022-06-15,3,4,0,4,69.2,0
Heart Lake心湖,2022-06-16,3,4,0,4,69.2,0
Gift from the Gods,2022-06-20,1,4,0,4,69.2,0
Defenders of Asteria,2022-07-12,2,4,0,4,69.2,0
Blastonier,2022-08-25,1,4,0,4,69.2,0
你与选择 You and Choice,2022-06-25,2,4,0,4,69.2,0
凶宅 HouseHaunting,2022-07-08,4,4,0,4,69.2,0
By the Vine,2022-07-16,2,4,0,4,69.2,0
Hitstream,2022-10-31,2,4,0,4,69.2,0
Wormmy,2022-10-21,2,4,0,4,69.2,0
Alien Gladiator,2022-07-07,2,4,0,4,69.2,0
Hold Controller,2022-07-19,2,4,0,4,69.2,0
WalkBot,2022-08-25,2,4,0,4,69.2,0
Cyber Drift,2022-07-04,2,4,0,4,69.2,0
わんおぺ寿司,2022-07-16,5,4,0,4,69.2,0
夺宝蠢兵,2022-08-17,1,4,0,4,69.2,0
Rush Rush Rally Reloaded,2022-08-04,2,4,0,4,69.2,0
Auf Wiedersehen Monty,2022-07-18,3,4,0,4,69.2,0
The Apple Tree,2022-12-30,3,4,0,4,69.2,0
Ansiolisis,2022-07-19,2,4,0,4,69.2,0
OrbiTank,2022-08-12,6,4,0,4,69.2,0
魔法少女が殺された。-名誉の死と陰の迷宮-,2022-08-24,4,4,0,4,69.2,0
PASSAGE,2022-07-22,2,4,0,4,69.2,0
PASSAGE,2022-07-22,2,4,0,4,69.2,0
PASSAGE,2018-11-14,2,4,5,9,47.22,0
PASSAGE,2018-11-14,2,4,5,9,47.22,0
Controller Sync,2022-07-21,2,4,0,4,69.2,0
Energy Tail,2022-09-18,3,4,0,4,69.2,0
Just Shoot: Slimes,2022-10-14,2,4,0,4,69.2,0
A Frog's Job,2022-10-07,1,4,0,4,69.2,0
Mongrel Games Minigames,2022-10-25,1,4,0,4,69.2,0
Pathogen: Survival,2022-11-03,3,4,0,4,69.2,0
Canfield Solitaire Collection,2022-08-31,2,4,0,4,69.2,0
Pussies Wrestling Dicks,2022-08-18,1,4,0,4,69.2,0
Dork,2022-10-25,3,4,0,4,69.2,0
graveyard keeper,2022-08-13,2,4,0,4,69.2,0
Stanislav,2022-10-20,3,4,0,4,69.2,0
Neon Dungeon,2022-08-26,2,4,0,4,69.2,0
Terrorform,2022-09-05,4,4,0,4,69.2,0
PERCNOPS VIRTUAL RIG,2022-11-20,2,4,0,4,69.2,0
Beam Splitter,2022-08-29,4,4,0,4,69.2,0
Puck Runner,2022-09-01,1,4,0,4,69.2,0
Hooligan James,2022-09-12,2,4,0,4,69.2,0
Mr.Addon Game Maker,2022-09-01,1,4,0,4,69.2,0
Discvivors,2022-09-05,3,4,0,4,69.2,0
Christmas Blaster,2022-12-07,2,4,0,4,69.2,0
Tankron,2022-11-19,3,4,0,4,69.2,0
ALPHA BOX,2022-09-08,3,4,0,4,69.2,0
Save and Conquer : 8 Years,2022-09-01,2,4,0,4,69.2,0
Asteroids and more asteroids,2022-09-30,1,4,0,4,69.2,1
Super Jagger Bomb,2022-10-06,3,4,0,4,69.2,0
Slide Girls,2022-09-14,2,4,0,4,69.2,0
Learning Geography: Countries of the World,2022-09-30,2,4,0,4,69.2,0
Mycorrhiza,2022-09-30,2,4,0,4,69.2,1
Heartless,2022-10-09,1,4,0,4,69.2,0
Ant in Training,2022-09-15,1,4,0,4,69.2,0
Super hamsterball,2022-11-25,2,4,0,4,69.2,0
Catherine Ragnor - Blackbeards Fury,2022-09-14,3,4,0,4,69.2,0
32 in 1 Game Special,2022-10-13,2,4,0,4,69.2,0
MIRACLE SWEEPER,2022-12-23,3,4,0,4,69.2,0
ボクらのウィンタースポーツ,2022-12-08,2,4,0,4,69.2,0
Soul Searching,2022-10-06,3,4,0,4,69.2,0
Soul Searching,2022-10-06,3,4,0,4,69.2,0
Soul Searching,2017-02-15,21,240,29,269,81.95,0
Soul Searching,2017-02-15,21,240,29,269,81.95,0
Jam Above Jam Below,2022-09-21,2,4,0,4,69.2,0
ALIEN WAR,2022-09-23,1,4,0,4,69.2,0
Dodge The Missionaries,2022-09-20,2,4,0,4,69.2,0
Maskonauts: Chat'Attack,2022-12-05,2,4,0,4,69.2,0
Score Gun,2022-09-27,3,4,0,4,69.2,0
Dancing Pandas,2022-12-25,6,4,0,4,69.2,0
Masterchef Ice Cream Edition,2022-10-12,2,4,0,4,69.2,0
Petty's Adventure: Desert,2022-09-30,2,4,0,4,69.2,0
Camouflet,2022-10-31,2,4,0,4,69.2,0
Big Adventure: Trip to Europe 3 - Collector's Edition,2022-10-16,3,4,0,4,69.2,0
Road Trip USA 2: West,2022-11-29,4,4,0,4,69.2,1
It's Locked,2022-10-31,2,4,0,4,69.2,0
Pogo Rage,2022-10-17,2,4,0,4,69.2,0
Candice DeBébé's Tantalising Tricks,2022-11-16,4,4,0,4,69.2,0
Brisk Square,2022-12-23,2,4,0,4,69.2,0
Brisk Square,2022-12-23,2,4,0,4,69.2,0
Brisk Square,2021-06-04,137,65,13,78,74.39,0
Brisk Square,2021-06-04,137,65,13,78,74.39,0
五代十国之玉知,2022-12-12,2,4,0,4,69.2,0
LOCOSOCCER,2022-12-07,7,4,0,4,69.2,0
Brutal TD,2022-12-16,2,4,0,4,69.2,0
Cozy Corner,2022-11-06,3,4,0,4,69.2,0
Jewel Match Twilight 2,2022-10-27,8,4,0,4,69.2,0
Uproot,2022-11-04,3,4,0,4,69.2,1
Teresa Moontyners - In the lair of the beast,2022-12-14,5,4,0,4,69.2,0
你微笑的一百种样子,2022-11-10,2,4,0,4,69.2,0
Talesworth Adventure: The Lost Artifacts,2022-11-21,2,4,0,4,69.2,0
A meeting of dreams,2022-12-16,2,4,0,4,69.2,0
Super Crazy Chickens,2022-11-01,3,4,0,4,69.2,0
Illumina Girls,2022-10-26,2,4,0,4,69.2,0
Martian Invaders,2022-11-24,1,4,0,4,69.2,0
The Witch's House,2022-10-27,2,4,0,4,69.2,0
sunny-place-2,2022-11-30,6,4,0,4,69.2,0
Princess Ruby,2022-12-08,2,4,0,4,69.2,0
Outworld Patrol,2022-12-12,2,4,0,4,69.2,0
简单滚动,2022-12-26,1,4,0,4,69.2,0
Finding Fifi,2022-12-01,3,4,0,4,69.2,0
Velocity Rift,2022-12-31,2,4,0,4,69.2,0
Graceward - Complete Edition,2022-12-26,2,4,0,4,69.2,0
Extinction / Zombie İnvasion 1,2022-12-08,2,4,0,4,69.2,0
Beau & Bow,2022-12-21,4,4,0,4,69.2,0
Word x Word,2022-12-25,3,4,0,4,69.2,0
Pot Farmer,2022-12-29,2,4,0,4,69.2,0
Sword of Fargoal,2022-12-16,4,4,0,4,69.2,0
CulixCupric's Temeritus: Dark Scion,2022-12-27,3,4,0,4,69.2,0
Amanda's Magic Book 5: Hansel and Gretel,2022-12-23,3,4,0,4,69.2,1
Cartoon Cagematch,2022-12-30,2,4,0,4,69.2,0
Flat Eye👁️‍🗨️,2022-11-14,90,77,25,102,69.17,2
Bulanci,2022-11-14,234,148,52,200,69.14,1
Tyrant's Blessing,2022-08-08,235,135,47,182,69.14,3
My Bunny Girl,2022-08-08,7,55,17,72,69.14,0
STRANGER,2022-08-11,11,41,12,53,69.12,0
Sunline,2022-05-16,6,41,12,53,69.12,0
I Am Jesus Christ: Prologue,2022-12-01,178,591,230,821,69.07,3
Rover Builder,2022-03-28,52,52,16,68,69.07,0
ELIF,2022-01-10,18,52,16,68,69.07,1
Welcome to Chornobayivka VR,2022-08-08,8,52,16,68,69.07,0
Talent Club ~ Match 3 Puzzle,2022-11-18,40,52,16,68,69.07,0
Trip In Another World,2022-06-17,729,768,303,1071,69.05,0
My Newborn Life In A Harem,2022-03-29,187,198,72,270,69.01,0
My Stepsis is a Furry Futa Fox,2022-10-06,6,60,19,79,69.01,2
Animallica,2022-03-05,126,613,240,853,69.0,9
Farmland Realm,2022-07-09,12,49,15,64,69.0,0
HideAlone,2022-08-12,28,84,28,112,68.98,0
Rescuing You in the Infinite Loop,2022-06-23,34,68,22,90,68.98,0
Rift Loopers,2022-09-22,111,68,22,90,68.98,0
神都不良探,2022-04-28,1565,1696,693,2389,68.97,2
Fleet Commander: Pacific,2022-07-21,11,11,2,13,68.97,0
Basketball Madness,2022-06-03,3,11,2,13,68.97,0
Drunken Nuke'em,2022-07-28,11,11,2,13,68.97,0
Blazend,2022-01-07,3,11,2,13,68.97,0
Strangest.io's My Megamix '21,2022-04-06,5,11,2,13,68.97,0
Refraction: Beyond the Mirror,2022-01-07,3,11,2,13,68.97,0
Would you like to run an idol café? 3,2022-05-09,4,11,2,13,68.97,0
Catch them!,2022-01-21,8,11,2,13,68.97,0
安特卫普的尼洛 Nello in Antwerp,2022-02-12,5,11,2,13,68.97,0
Surreal Experience,2022-08-02,2,11,2,13,68.97,0
Mire,2022-05-05,6,11,2,13,68.97,0
The Doll Beneath,2022-08-16,8,11,2,13,68.97,0
The Ultimate Shot,2022-03-15,2,11,2,13,68.97,0
Spelldash,2022-08-19,2,11,2,13,68.97,0
Wind Angel Ⅲ,2022-03-31,3,11,2,13,68.97,0
DIRTYBLOCK,2022-05-17,3,11,2,13,68.97,0
The Smash Cars Tournament,2022-04-11,2,11,2,13,68.97,0
This is a game,2022-04-26,2,11,2,13,68.97,0
Wands Alliances,2022-10-05,7,11,2,13,68.97,0
SpearFrog,2022-05-26,2,11,2,13,68.97,0
My Furry Maid,2022-11-19,7,11,2,13,68.97,0
Space Turbo,2022-05-24,5,11,2,13,68.97,0
Isolania,2022-07-14,3,11,2,13,68.97,0
Over City,2022-06-08,2,11,2,13,68.97,0
Metapilot,2022-09-10,4,11,2,13,68.97,0
Road Stones,2022-10-20,7,11,2,13,68.97,0
Dagger of heroes,2022-08-30,2,11,2,13,68.97,0
PARKET Evolution,2022-08-25,3,11,2,13,68.97,0
Stunts Contest Beach Edition,2022-10-10,3,11,2,13,68.97,0
ParkTo,2022-09-13,14,11,2,13,68.97,0
Air defenders,2022-10-03,5,11,2,13,68.97,0
Slippery Richard! ~ He's Taller Than My Husband ~,2022-10-25,4,11,2,13,68.97,0
Feathered Run: Worlds,2022-11-08,2,11,2,13,68.97,0
Hidden Harbor 2 Top-Down 3D,2022-11-15,2,11,2,13,68.97,0
仙侠世界2,2022-01-21,122,285,107,392,68.94,4
Guns N' Boxes,2022-01-20,45,57,18,75,68.94,0
Cliff & Field Tower Defense,2022-11-04,20,32,9,41,68.94,0
Grid Miner,2022-05-03,11,32,9,41,68.94,0
Cyberpunk Girls,2022-02-05,22,32,9,41,68.94,0
Force of Warships,2022-08-09,50,110,38,148,68.93,24
Hello Neighbor 2,2022-12-06,674,1062,429,1491,68.88,21
Rugby 22,2022-01-27,125,161,58,219,68.88,24
HEXAD,2022-07-28,22,29,8,37,68.88,0
ZHP: Unlosing Ranger vs. Darkdeath Evilman,2022-05-10,57,29,8,37,68.88,0
Pirate Booty and the Bukkake Buccaneer,2022-03-11,20,29,8,37,68.88,0
Hokko Life,2022-09-27,1020,1341,547,1888,68.86,53
Titanic: Fall Of A Legend,2022-02-11,19,43,13,56,68.85,0
Pirate Jam,2022-02-16,4,26,7,33,68.83,0
Nightfall,2022-04-08,6,26,7,33,68.83,0
Nightfall,2022-04-08,6,26,7,33,68.83,0
Nightfall,2021-04-25,24,27,15,42,59.68,0
Nightfall,2021-04-25,24,27,15,42,59.68,0
Food Factory,2022-08-20,16,26,7,33,68.83,0
Frozen Flame,2022-11-17,5499,1654,681,2335,68.82,113
Sky Haven,2022-11-21,674,691,275,966,68.81,23
Dolly Wars - Auto Tactics,2022-12-16,20,14,3,17,68.8,0
Beat Stickman: Beyond,2022-09-06,11,14,3,17,68.8,0
Burnit Quest,2022-04-01,3,14,3,17,68.8,0
REDSHOT,2022-08-02,4,14,3,17,68.8,0
Enigmarella,2022-02-28,3,14,3,17,68.8,0
YUZA,2022-06-05,3,14,3,17,68.8,0
Rivalia: Dungeon Raiders,2022-10-05,4,14,3,17,68.8,0
PH0B0S,2022-07-10,5,14,3,17,68.8,0
Portal Defense,2022-07-12,4,14,3,17,68.8,0
Worker Riot,2022-06-13,2,14,3,17,68.8,0
Nuclear Fighter,2022-07-04,2,14,3,17,68.8,0
Paresis,2022-07-18,2,14,3,17,68.8,0
Futa University,2022-07-21,8,14,3,17,68.8,0
Cube Adventure,2022-08-26,7,14,3,17,68.8,0
Lawnmower Game: Space Race,2022-09-05,4,14,3,17,68.8,0
함부로 소설 쓰지 맙시다,2022-11-18,9,14,3,17,68.8,0
DICE GAME,2022-11-23,1,14,3,17,68.8,0
Lab Inspect,2022-11-21,3,14,3,17,68.8,0
Hentai Ojou,2022-12-16,5,14,3,17,68.8,0
Kingdom's Life,2022-02-28,79,150,54,204,68.79,0
Lust&Magic -Chisalla in a Flower Basket-,2022-06-04,35,23,6,29,68.78,0
The Tree,2022-03-17,5,23,6,29,68.78,0
The Tree,2022-03-17,5,23,6,29,68.78,0
The Tree,2020-11-12,3,1,2,3,44.31,0
The Tree,2020-11-12,3,1,2,3,44.31,0
Mare,2022-04-01,6,23,6,29,68.78,0
Yokai Hunter Shintaro,2022-05-03,4,23,6,29,68.78,0
Yokai's Wish,2022-12-08,5,23,6,29,68.78,0
Odd Woods,2022-11-01,10,23,6,29,68.78,0
Killer in the cabin,2022-05-12,49,75,25,100,68.77,0
无尽守卫,2022-07-08,35,40,12,52,68.77,0
The Hand of Merlin,2022-06-14,150,220,82,302,68.76,9
Unexplored 2: The Wayfarer's Legacy,2022-05-27,157,180,66,246,68.76,6
From Space,2022-11-03,4402,1074,437,1511,68.75,18
Scuffy Game,2022-02-18,43,88,30,118,68.75,0
Caravan Trade Tycoon,2022-09-14,5,20,5,25,68.75,0
Gigant,2022-08-12,6,20,5,25,68.75,0
Bobbi Adventure,2022-05-20,4,20,5,25,68.75,0
Valkyrie Champions,2022-10-12,9,20,5,25,68.75,0
Village Monsters,2022-03-22,9,17,4,21,68.75,0
It'sRoachTime!,2022-03-08,16,17,4,21,68.75,0
Carnage Cross,2022-11-25,3,17,4,21,68.75,0
Hot Milf 4,2022-03-05,3,17,4,21,68.75,0
Koncolos,2022-08-02,8,17,4,21,68.75,0
HexTD,2022-09-30,5,17,4,21,68.75,0
Sleep Paralysis: The Uncanny Valley,2022-12-14,7,17,4,21,68.75,0
FETUS,2022-07-04,7,17,4,21,68.75,0
Police on Duty,2022-07-25,2,17,4,21,68.75,0
Galaxy Survivors,2022-08-17,12,17,4,21,68.75,0
Basement of Hellish,2022-12-02,3,17,4,21,68.75,0
Isla Sinaloa,2022-10-10,174,93,32,125,68.71,2
修仙立志传,2022-06-21,1732,934,379,1313,68.7,169
孙美琪疑案：雨儿胡同,2022-11-11,52,48,15,63,68.7,0
Wizard's Wheel 2,2022-12-23,356,72,24,96,68.69,110
Zorya,2022-02-08,14,37,11,48,68.69,0
Ballfrog,2022-01-28,9,37,11,48,68.69,0
Spirit Of The Island,2022-08-17,665,729,293,1022,68.68,68
Idle Baker Boss,2022-08-15,138,56,18,74,68.68,20
타워 오브 판타지,2022-10-19,528,164,60,224,68.67,21
Phantom Breaker: Omnia,2022-03-14,109,121,43,164,68.67,2
LAZ3RZ,2022-08-24,29,90,31,121,68.64,0
DEADCRAFT,2022-05-19,203,77,26,103,68.64,3
Great Deceiver,2022-08-05,54,77,26,103,68.64,0
LiMiT's Escape Room Games,2022-04-17,18,45,14,59,68.61,0
Roboplant,2022-11-10,26,34,10,44,68.6,0
Painting VR,2022-04-14,8,34,10,44,68.6,1
Veggie Menace,2022-07-30,20,34,10,44,68.6,0
Ouija Rumours,2022-02-13,7,31,9,40,68.51,0
Shadow Era,2022-04-04,17,31,9,40,68.51,0
Legend of Feather,2022-12-16,224,31,9,40,68.51,0
COGEN: Sword of Rewind / COGEN: 大鳥こはくと刻の剣,2022-01-26,72,58,19,77,68.5,0
Timeline Walker Dark World,2022-09-26,375,58,19,77,68.5,0
Maestro VR,2022-11-05,9,50,16,66,68.49,0
Farm Defense,2022-08-01,338,50,16,66,68.49,1
Second Thoughts,2022-07-12,7,50,16,66,68.49,0
Torchlight: Infinite,2022-10-11,21030,4897,2113,7010,68.48,293
Werewolf: The Apocalypse - Earthblood,2022-02-07,87,282,109,391,68.46,25
Incremental Epic Hero 2,2022-07-22,3100,500,200,700,68.45,"1,441"
MAGICAL ANGEL FAIRY HEART,2022-05-12,20,63,21,84,68.44,0
Mutant Alley: Dinohazard,2022-04-15,9,39,12,51,68.41,0
重回哩世界,2022-12-04,13,28,8,36,68.41,0
Package Inspector,2022-04-15,33,28,8,36,68.41,0
Ocean Is Home : Island Life Simulator,2022-12-09,25,68,23,91,68.39,4
Retrieving The Past Steam EDITION,2022-04-08,61,47,15,62,68.39,1
Blind Fate: Edo no Yami,2022-09-15,33,86,30,116,68.38,3
looK INside - Chapter 2,2022-09-19,41,25,7,32,68.31,1
YouRiding - Surfing and Bodyboarding Game,2022-09-15,11,25,7,32,68.31,1
Elf Wives Cheat to Ride my Meat,2022-02-18,14,25,7,32,68.31,0
VEREDA - Mystery Escape Room Adventure,2022-02-26,9,25,7,32,68.31,2
Office Run,2022-06-01,12,25,7,32,68.31,0
Relayer Advanced,2022-10-26,46,36,11,47,68.3,2
Chance at Life,2022-06-09,5,36,11,47,68.3,0
Thunder League,2022-05-02,31,65,22,87,68.29,5
PUNCH FIT,2022-09-12,11,65,22,87,68.29,0
Linguist FPS - The Language Learning FPS,2022-05-20,31,88,31,119,68.28,10
The Dark Pictures Anthology: House of Ashes - Friend's Pass,2022-01-28,114,165,62,227,68.26,7
Loot River,2022-05-03,274,235,91,326,68.22,4
Furry Cyberfucker,2022-04-09,161,230,89,319,68.21,1
The Demon Lord Is New in Town!,2022-01-25,158,80,28,108,68.21,0
Throbax TD,2022-11-17,10,22,6,28,68.2,0
Blown Away,2022-01-24,16,22,6,28,68.2,0
DOGE TO THE MOON,2022-05-07,42,22,6,28,68.2,0
The Tribe Game,2022-03-25,18,22,6,28,68.2,0
Cooking Festival,2022-05-19,14,22,6,28,68.2,1
Dismantled Director's cut,2022-07-01,8,22,6,28,68.2,0
Ruadh: Warbands,2022-12-16,8,22,6,28,68.2,0
Cosplay Collection,2022-11-11,90,120,44,164,68.19,0
ValiDate: Volume 1,2022-09-29,80,62,21,83,68.19,1
Before The Last Hour,2022-05-16,24,33,10,43,68.18,0
Meet Cute: Cafe,2022-03-12,7,41,13,54,68.17,0
Nitroverse,2022-02-12,2,7,1,8,68.15,0
Beastie Land,2022-02-27,4,7,1,8,68.15,0
Rimebeard,2022-01-03,3,7,1,8,68.15,0
PushOps,2022-04-11,3,7,1,8,68.15,0
Dancing Cube,2022-08-12,5,7,1,8,68.15,0
Fairground Power Polyp Simulator,2022-12-02,6,7,1,8,68.15,0
LiveScream,2022-10-27,2,7,1,8,68.15,0
Roll For Initiative,2022-03-08,2,7,1,8,68.15,0
Insect Seeker,2022-10-11,2,7,1,8,68.15,0
Fantasteroids,2022-09-26,2,7,1,8,68.15,0
Paranormal Organization: Magic Academy,2022-06-20,4,7,1,8,68.15,0
Sakura Segment 0.3,2022-11-04,4,7,1,8,68.15,0
Unriddle,2022-01-20,44,7,1,8,68.15,0
BACK and BACK to Hell,2022-01-17,3,7,1,8,68.15,0
The Vortex,2022-03-18,9,7,1,8,68.15,0
MaDevil,2022-05-31,2,7,1,8,68.15,0
Xolotl,2022-06-27,3,7,1,8,68.15,0
Click Quest 3D 2: Plus,2022-03-27,4,7,1,8,68.15,0
CASTILLO - SHATTERED MIRRORS,2022-03-25,3,7,1,8,68.15,0
Tremblay Island,2022-05-24,3,7,1,8,68.15,0
Vacuum Ball,2022-02-23,2,7,1,8,68.15,0
Super Slinger,2022-03-01,2,7,1,8,68.15,0
Ultimate Super Bean,2022-03-16,4,7,1,8,68.15,0
Medieval Sex Jigsaw,2022-04-29,3,7,1,8,68.15,0
1001 Jigsaw. Cute Cats,2022-03-14,6,7,1,8,68.15,1
New Lands Paradise Island Collector's Edition,2022-03-29,8,7,1,8,68.15,0
Trivia Party,2022-04-01,4,7,1,8,68.15,0
HRD 3 Pegasus Island,2022-04-28,3,7,1,8,68.15,0
Operation Pill,2022-05-02,2,7,1,8,68.15,0
Easter Eggstravaganza,2022-04-15,2,7,1,8,68.15,0
The Ducksuckers,2022-04-09,3,7,1,8,68.15,0
Bubble Shot,2022-06-20,15,7,1,8,68.15,0
K3LVN,2022-08-09,5,7,1,8,68.15,0
Down Fast VR,2022-12-15,3,7,1,8,68.15,0
Bloodied Fear,2022-05-03,1,7,1,8,68.15,0
Charmareians,2022-06-17,4,7,1,8,68.15,0
Suddenly Meow 2,2022-04-27,3,7,1,8,68.15,0
Deep,2022-05-18,2,7,1,8,68.15,0
Find Your Wings,2022-10-25,12,7,1,8,68.15,0
Future Mirror,2022-11-01,2,7,1,8,68.15,0
死亡旅店Ⅱ亡者归来-Death Inn Ⅱ The Immortal Is Coming,2022-06-21,4,7,1,8,68.15,0
Sakura Alien 2,2022-09-19,8,7,1,8,68.15,0
Protect My Cheese,2022-10-10,3,7,1,8,68.15,0
Mini Arenas,2022-11-25,4,7,1,8,68.15,0
Milf Toys 3,2022-08-05,3,7,1,8,68.15,0
Outatime,2022-09-14,4,7,1,8,68.15,0
Gyro Gear Tournament+,2022-09-28,2,7,1,8,68.15,0
Demong Hunter,2022-10-05,5,7,1,8,68.15,0
Folktale,2022-09-02,1,7,1,8,68.15,0
Science Girls,2022-08-27,3,7,1,8,68.15,0
Science Girls,2022-08-27,3,7,1,8,68.15,0
Science Girls,2014-03-21,50,103,50,153,63.52,0
Science Girls,2014-03-21,50,103,50,153,63.52,0
Peregrine,2022-09-20,2,7,1,8,68.15,0
Chris Isn't Alone,2022-09-12,8,7,1,8,68.15,2
Ami's Room,2022-09-19,4,7,1,8,68.15,0
Memory's Abyss,2022-09-22,2,7,1,8,68.15,0
ネクロサーガ,2022-11-03,4,7,1,8,68.15,0
Taxi Taxi Sim,2022-11-02,2,7,1,8,68.15,0
Cold Massacre,2022-10-18,4,7,1,8,68.15,0
Stealth,2022-11-16,4,7,1,8,68.15,0
Jack,2022-10-19,3,7,1,8,68.15,0
Epic Princess,2022-11-18,2,7,1,8,68.15,0
Fallen Stars,2022-11-25,4,7,1,8,68.15,0
Vega,2022-12-21,1,7,1,8,68.15,0
Mystery of Fortune 2 Refine,2022-01-25,397,72,25,97,68.13,0
Smart Factory Tycoon,2022-03-26,118,112,41,153,68.11,11
Magi: Mind Game,2022-05-04,34,19,5,24,68.1,0
Where is Paradise?,2022-01-19,25,19,5,24,68.1,0
ClayTown Horror,2022-10-25,8,19,5,24,68.1,0
Cthulhu Dungeon,2022-02-18,11,19,5,24,68.1,0
Follow the Black Kitten,2022-01-17,4,19,5,24,68.1,0
人中怪物,2022-05-13,8,19,5,24,68.1,0
Slaughter Cannon,2022-01-05,5,19,5,24,68.1,0
Reality Simulator,2022-08-02,3,19,5,24,68.1,1
Quantum Tripper,2022-05-27,5,19,5,24,68.1,0
Shining Jump Jump,2022-06-13,6,19,5,24,68.1,0
Neuro Horror,2022-10-06,3,19,5,24,68.1,0
Drag and Drop,2022-11-21,2,19,5,24,68.1,0
Furry Killer,2022-11-19,3,19,5,24,68.1,1
Rebellion,2022-02-04,11,46,15,61,68.07,0
Demented,2022-07-26,4507,64,22,86,68.05,5
The Hunsa Magic,2022-05-19,31,30,9,39,68.05,1
Deer Journey,2022-07-21,4,30,9,39,68.05,0
Who Knocks,2022-12-26,12,30,9,39,68.05,1
Ankora: Lost Days,2022-09-16,30,38,12,50,68.04,0
Broken Banners,2022-03-31,21,38,12,50,68.04,4
Itchy Scratchy,2022-09-05,7,51,17,68,68.01,0
Valand,2022-11-04,4,51,17,68,68.01,0
Starsand,2022-11-17,541,583,241,824,68.0,31
CuVRball,2022-11-27,10,16,4,20,68.0,0
Vaporwave World,2022-10-08,2,16,4,20,68.0,0
Unlife,2022-06-07,5,16,4,20,68.0,0
Her Heart's Desire: A Landlord Epic,2022-11-18,28,16,4,20,68.0,4
The Guardian Stone,2022-10-22,6,16,4,20,68.0,0
Intense Love Shot,2022-01-07,6,16,4,20,68.0,2
Christmas Panic,2022-01-18,6,16,4,20,68.0,0
Kakureza Library,2022-01-24,17,16,4,20,68.0,0
Monsters and Weapons,2022-02-09,16,16,4,20,68.0,0
Rugby Union Team Manager 4,2022-11-30,25,16,4,20,68.0,10
Goddess Of War Ashley Ⅱ,2022-03-04,4,16,4,20,68.0,0
Die drei ??? - Plan der Chamäleonbande,2022-04-06,16,16,4,20,68.0,1
Underscore,2022-10-11,7,16,4,20,68.0,0
Kaz's Adventure,2022-09-05,8,16,4,20,68.0,0
Voxrush,2022-09-01,3,16,4,20,68.0,0
Spin Time,2022-12-02,4,16,4,20,68.0,0
Save the Kingdom,2022-10-12,18,16,4,20,68.0,0
Ants of Duty,2022-11-21,2,16,4,20,68.0,0
My Soul Forever,2022-11-21,2,16,4,20,68.0,0
Social Credit Simulator,2022-11-23,4,16,4,20,68.0,0
Castaway of the Ardusta Sea,2022-07-09,126,56,19,75,67.97,0
Age of Grit,2022-05-03,14,43,14,57,67.95,1
Adventures of the Old Testament - The Bible Video Game,2022-09-14,13,43,14,57,67.95,0
末路希冀,2022-04-28,9,13,3,16,67.93,0
雾尽时分,2022-03-04,9,13,3,16,67.93,0
Treasure Temples,2022-02-03,5,13,3,16,67.93,0
Happy Island Life,2022-03-29,4,13,3,16,67.93,0
Spooky Story,2022-02-02,5,13,3,16,67.93,0
Kapellmeister,2022-05-13,2,13,3,16,67.93,0
SCALEPLANET,2022-05-24,5,13,3,16,67.93,0
En•Fem•E No. 9: Reborn,2022-03-23,8,13,3,16,67.93,1
Sway,2022-04-26,3,13,3,16,67.93,0
Yuonger Adventure,2022-06-25,2,13,3,16,67.93,0
Eternal Pinball RPG,2022-06-11,4,13,3,16,67.93,0
Ragedanger Earth,2022-06-25,2,13,3,16,67.93,0
Bring It On!,2022-06-20,17,13,3,16,67.93,0
Mystical Island,2022-07-15,8,13,3,16,67.93,0
Another World Quest,2022-08-03,5,13,3,16,67.93,0
Blacksmith Weapon Merchant,2022-08-24,8,13,3,16,67.93,2
Let's Go Camping,2022-09-30,2,13,3,16,67.93,0
Highway Cross,2022-10-17,2,13,3,16,67.93,0
Station 117,2022-11-23,9,13,3,16,67.93,0
Halt,2022-11-19,1,13,3,16,67.93,0
Lethal Running,2022-10-19,7,10,2,12,67.93,0
Pixel Happy Game Girls,2022-12-17,3,10,2,12,67.93,0
VOID: Arena (alpha),2022-04-22,3,10,2,12,67.93,0
Ruggnar,2022-06-23,6,10,2,12,67.93,0
JumpBeard,2022-05-12,3,10,2,12,67.93,0
Crossing Guard Joe,2022-03-04,3,10,2,12,67.93,0
Guardian Force - Saturn Tribute,2022-02-09,5,10,2,12,67.93,0
无限战魂 Infinity BattleSoul,2022-01-28,8,10,2,12,67.93,0
Turn off the light,2022-01-27,4,10,2,12,67.93,0
Tekla,2022-10-03,4,10,2,12,67.93,0
Vitality Girl Ⅱ:Fire,2022-02-25,3,10,2,12,67.93,0
Chicken Coop,2022-05-17,2,10,2,12,67.93,0
『絵話 -kaiwa-』,2022-06-08,6,10,2,12,67.93,0
Minebot expedition,2022-04-02,6,10,2,12,67.93,0
Spoils Of War,2022-03-30,7,10,2,12,67.93,0
Fun Quest,2022-03-30,5,10,2,12,67.93,0
Surface Rush,2022-06-02,2,10,2,12,67.93,0
Cowboy Hell,2022-09-22,4,10,2,12,67.93,0
Toe To Toe Party Games,2022-04-20,4,10,2,12,67.93,0
soul,2022-06-17,6,10,2,12,67.93,0
Nocturama,2022-04-21,4,10,2,12,67.93,0
AIRBORNE,2022-04-16,3,10,2,12,67.93,0
Hypnosis Reveries,2022-05-20,3,10,2,12,67.93,0
Run n Jump,2022-05-08,3,10,2,12,67.93,0
SPLAIT RAGE,2022-06-25,1,10,2,12,67.93,0
Brain Exam with Benefits 2,2022-07-04,7,10,2,12,67.93,0
69 Andariel Hot,2022-07-18,4,10,2,12,67.93,0
Slime Rule,2022-07-14,10,10,2,12,67.93,0
Elementals: The Magic Key,2022-07-22,5,10,2,12,67.93,2
Freestyle Mage 无穷秘法师,2022-09-26,6,10,2,12,67.93,0
Tribe Explorer,2022-08-24,3,10,2,12,67.93,0
Puzzle: Nature 2,2022-08-30,3,10,2,12,67.93,0
Platonically Mauled by a Magic Cougar,2022-10-25,5,10,2,12,67.93,0
Crossword World Puzzle,2022-12-12,11,10,2,12,67.93,3
Battle Robots,2022-11-17,4,10,2,12,67.93,0
My Darkest Witch,2022-11-19,2,10,2,12,67.93,0
Digital Frida,2022-11-25,3,10,2,12,67.93,0
Furry Arena [18+],2022-12-01,251,283,113,396,67.92,0
Doors of Insanity,2022-01-27,92,152,58,210,67.91,1
中国战疫,2022-01-22,11,27,8,35,67.91,0
Desktop Dog,2022-04-07,10,27,8,35,67.91,1
山海天下：熊猫战纪,2022-09-09,6,27,8,35,67.91,0
Ellisar,2022-05-09,32,93,34,127,67.84,0
TFM: The First Men,2022-11-02,473,218,86,304,67.83,3
FreestyleFootball R,2022-09-13,1166,884,376,1260,67.81,214
Wrath of Anias,2022-03-02,12,40,13,53,67.81,0
Virago: Herstory,2022-11-24,12,40,13,53,67.81,0
Spire of Glory,2022-12-03,210,73,26,99,67.8,0
F1® 22,2022-07-01,25172,14922,6802,21724,67.76,"5,386"
Derpy Conga,2022-02-10,4,24,7,31,67.76,0
Hentai Possess-Her,2022-01-07,4,24,7,31,67.76,0
Cat Adventure 2,2022-03-16,3,24,7,31,67.76,0
Hentai Pussy 3,2022-06-10,3,24,7,31,67.76,0
Delivery Man,2022-11-25,13,24,7,31,67.76,0
Tank Mechanic Simulator VR: Prologue,2022-04-15,20,45,15,60,67.75,1
Perfect Date,2022-11-08,17,45,15,60,67.75,0
Machina Blade,2022-09-07,23,32,10,42,67.75,0
Noctem,2022-07-01,9,32,10,42,67.75,0
In to the 029,2022-07-11,10,32,10,42,67.75,0
Truck Mechanic: Dangerous Paths - Prologue,2022-06-02,931,336,137,473,67.74,3
MIGHT'N MOW'EM,2022-10-24,64,90,33,123,67.74,0
HordeCore,2022-03-02,57,85,31,116,67.73,0
Mage Noir - Infinity,2022-06-30,22,85,31,116,67.73,4
Z-Collapse,2022-09-01,51,50,17,67,67.71,1
Spooky Starlets,2022-06-23,190,335,137,472,67.69,0
Ignited Steel,2022-03-09,42,55,19,74,67.69,0
Monster Outbreak,2022-10-03,98,65,23,88,67.68,1
One More Island,2022-05-16,259,133,51,184,67.65,2
Paper Cut Mansion,2022-10-27,25,37,12,49,67.65,0
Phantom Hysteria,2022-10-13,50,37,12,49,67.65,0
Wing Breakers,2022-03-11,68,104,39,143,67.64,0
Aero Tales Online: The World - Anime MMORPG,2022-08-01,533,373,154,527,67.63,26
CardMaker,2022-01-27,79,147,57,204,67.62,0
The Dragoness: Command of the Flame,2022-09-01,223,82,30,112,67.62,1
Summer Crush,2022-11-25,115,82,30,112,67.62,4
Jelle's Marble League,2022-10-05,57,94,35,129,67.59,3
Path of Kami: Journey begins,2022-11-09,9,21,6,27,67.59,0
Everblade,2022-05-06,11,21,6,27,67.59,0
My Giant Friend,2022-11-10,8,21,6,27,67.59,0
Sakura Mirror,2022-12-16,6,21,6,27,67.59,0
Bloody Efforts,2022-09-16,22,29,9,38,67.58,0
The Darkest Tales,2022-10-13,147,252,102,354,67.57,1
ITRP _ Volatile Vertex,2022-03-02,72,47,16,63,67.57,0
Tuk Tuk Extreme Simulator,2022-05-02,3,47,16,63,67.57,0
JBMod,2022-10-22,120,1629,717,2346,67.56,7
EdgeOfTheAbyssAwaken,2022-06-19,593,399,166,565,67.56,0
Ancient Witch Arena,2022-10-14,124,62,22,84,67.56,0
Hentai Houseparty: Gyaru Gangbang,2022-01-18,18,57,20,77,67.55,1
Clown Of Duty,2022-11-26,28,74,27,101,67.49,0
Mercenaries Rebirth,2022-06-30,65,34,11,45,67.48,0
Everything Is For Humanity,2022-06-24,13,86,32,118,67.45,1
World Empire 2027,2022-03-24,13,39,13,52,67.43,2
Chinatown Detective Agency,2022-04-07,78,81,30,111,67.42,0
世界の為の全ての少女,2022-02-23,209,81,30,111,67.42,0
Mad Pack,2022-02-10,55,192,77,269,67.41,1
TEMPUS,2022-03-02,6,44,15,59,67.41,0
守卫英雄,2022-10-14,21,44,15,59,67.41,3
Curse of Eternity,2022-12-01,6,18,5,23,67.4,0
Race me now,2022-08-26,3,18,5,23,67.4,0
ModBots,2022-03-16,4,18,5,23,67.4,0
Mannequin The Passing,2022-03-04,4,18,5,23,67.4,0
SnakeGame,2022-02-24,2,18,5,23,67.4,0
三国群英之兵临天下,2022-07-15,8,18,5,23,67.4,0
Lands of Sorcery,2022-06-10,23,26,8,34,67.39,0
Hot Cam,2022-07-28,24,26,8,34,67.39,0
Dark Waters: Gino and the Witch of the Black Swamp,2022-03-29,4,26,8,34,67.39,0
Rolando The Majestic,2022-05-23,304,26,8,34,67.39,0
Witch Story,2022-09-11,6,26,8,34,67.39,0
Nordicandia,2022-09-02,293,286,118,404,67.38,114
SCP: Nukalypse,2022-08-15,72,453,192,645,67.35,0
SCP: Daybreak,2022-07-23,33,133,52,185,67.35,1
小虎传：大菠萝深渊,2022-08-26,556,83,31,114,67.34,0
Gotham Knights,2022-10-21,24138,9906,4586,14492,67.33,604
Castle Morihisa,2022-02-10,391,260,107,367,67.32,4
Gunvolt Chronicles: Luminous Avenger iX 2,2022-01-27,339,246,101,347,67.3,0
Picontier,2022-04-01,173,90,34,124,67.3,0
En Route: Space,2022-05-06,10,31,10,41,67.3,0
Late photographer 4,2022-05-11,7,31,10,41,67.3,0
Die After Sunset,2022-02-11,37,56,20,76,67.28,0
Draconia,2022-01-13,282,350,147,497,67.27,4
Raubritter,2022-07-22,148,144,57,201,67.26,3
Mists of Noyah,2022-05-22,211,482,206,688,67.25,2
Lodestar,2022-07-08,44,46,16,62,67.24,0
Life on the hook,2022-02-21,5,41,14,55,67.24,0
An Elder Scrolls Legend: Battlespire,2022-04-26,9,41,14,55,67.24,0
Sacrifice Your Friends,2022-10-25,13,15,4,19,67.2,0
One Gun Guy,2022-03-11,2,15,4,19,67.2,1
Age of Jura,2022-10-31,9,15,4,19,67.2,1
Peril,2022-03-15,2,15,4,19,67.2,0
Россия наизнанку: Новый год,2022-02-01,3,15,4,19,67.2,0
PINK ELEPHANT,2022-01-04,3,15,4,19,67.2,0
HexoJago,2022-01-26,4,15,4,19,67.2,0
Rock Snake,2022-03-14,2,15,4,19,67.2,0
RUNES Magica,2022-05-02,8,15,4,19,67.2,0
LogiNode,2022-04-19,4,15,4,19,67.2,0
Hot Milf 5,2022-04-01,2,15,4,19,67.2,0
Date Ariane Remastered,2022-06-10,14,15,4,19,67.2,4
U96,2022-07-05,5,15,4,19,67.2,0
ESCAPE IT,2022-08-15,8,15,4,19,67.2,0
Hear Your Path,2022-08-30,4,15,4,19,67.2,0
The Block,2022-12-16,15,63,23,86,67.19,2
RaceLeague,2022-07-26,222,141,56,197,67.18,4
OnlyFap Simulator 3 💦,2022-10-29,968,134,53,187,67.18,0
嗜憶 Swallow,2022-06-29,4,23,7,30,67.18,0
Puzzle Park,2022-10-05,9,23,7,30,67.18,0
Oathbreakers,2022-10-18,7,23,7,30,67.18,1
The Story of The Flood,2022-12-23,16,53,19,72,67.12,0
Gold Wiper,2022-04-25,65,65,24,89,67.09,0
幻想三国志4外传,2022-01-09,45,48,17,65,67.09,0
Human Apocalypse - Reverse Horror Zombie Indie RPG Adventure,2022-02-28,20,48,17,65,67.09,0
Split,2022-04-06,11,28,9,37,67.09,0
Noah and Blackmagician,2022-02-14,29,28,9,37,67.09,0
PSYCHO,2022-03-11,7,28,9,37,67.09,0
Sushi Clicker,2022-12-10,4,28,9,37,67.09,0
Secrets of the Past: Mother's Diary,2022-01-13,3,3,0,3,67.06,0
Tank Warz!,2022-11-14,3,3,0,3,67.06,0
La Maledizione dell'Uccello Serpente,2022-02-22,2,3,0,3,67.06,0
Leviathan's Sword,2022-05-02,3,3,0,3,67.06,0
Luna Sky RDX,2022-08-08,2,3,0,3,67.06,0
R42,2022-06-18,3,3,0,3,67.06,0
Mystic,2022-03-08,4,3,0,3,67.06,0
MagiCarnage,2022-09-16,4,3,0,3,67.06,0
Sycamore,2022-06-30,4,3,0,3,67.06,0
Deep Abyss,2022-10-12,2,3,0,3,67.06,0
Grand Theft Rome,2022-02-16,1,3,0,3,67.06,0
Roadkill,2022-08-10,2,3,0,3,67.06,0
First Hero - Epic of Gilgamesh,2022-04-18,4,3,0,3,67.06,0
Self gunsbase,2022-11-17,1,3,0,3,67.06,0
Slide Stars,2022-04-29,2,3,0,3,67.06,0
Amazething,2022-03-22,2,3,0,3,67.06,0
Monolith,2022-03-13,1,3,0,3,67.06,0
Monolith,2022-03-13,1,3,0,3,67.06,2
Monolith,2017-06-07,133,1610,31,1641,92.93,0
Monolith,2017-06-07,133,1610,31,1641,92.93,2
Chompy Chomp Chomp Party,2022-11-17,7,3,0,3,67.06,0
Orpheus: Fall For Eurydice,2022-03-01,3,3,0,3,67.06,0
FREUS,2022-02-27,2,3,0,3,67.06,0
Oplitak,2022-02-04,3,3,0,3,67.06,0
Super Stupid Game,2022-06-17,4,3,0,3,67.06,0
AnotherQuizzGame,2022-07-26,3,3,0,3,67.06,0
Chunkers,2022-12-07,3,3,0,3,67.06,0
Kartoffl,2022-11-03,2,3,0,3,67.06,0
Juno's Journey,2022-01-21,2,3,0,3,67.06,0
Park Story,2022-10-20,2,3,0,3,67.06,0
Woods of Death 2,2022-04-08,2,3,0,3,67.06,0
Pair of Aces,2022-05-04,2,3,0,3,67.06,0
SYRAK: the War in the Middle-East,2022-05-16,2,3,0,3,67.06,0
Far Away Horse,2022-11-01,2,3,0,3,67.06,0
Tag Hop,2022-01-21,13,3,0,3,67.06,0
Objective H.A.S.T.E. - Survival Horror Escape,2022-03-03,1,3,0,3,67.06,0
Zahalia: The Curse of Zezor,2022-09-07,2,3,0,3,67.06,0
Dungeon Tactics,2022-04-25,5,3,0,3,67.06,0
Summer In Memoria,2022-04-20,1,3,0,3,67.06,0
Albert and Puzzle Mansion,2022-07-08,1,3,0,3,67.06,0
Side Effect,2022-03-10,4,3,0,3,67.06,0
Sexy Heroine! Part 3,2022-04-21,7,3,0,3,67.06,0
Ninja Usagimaru: Two Tails of Adventure,2022-01-26,3,3,0,3,67.06,0
AFTERGLOW,2022-10-11,1,3,0,3,67.06,0
Siren Head Horror Bunker VR,2022-03-31,2,3,0,3,67.06,0
Pico Islands,2022-02-28,3,3,0,3,67.06,0
Rebels - Under the Spell of Magic (Chapter 2),2022-03-23,1,3,0,3,67.06,0
Hoverbike Escape,2022-05-06,2,3,0,3,67.06,0
Run Ninja Run,2022-02-01,1,3,0,3,67.06,0
Bull3000VRTS,2022-08-22,2,3,0,3,67.06,0
YARG,2022-09-16,2,3,0,3,67.06,0
Seaside Driving,2022-03-16,3,3,0,3,67.06,0
Chill Panda,2022-03-31,2,3,0,3,67.06,0
Notoris: The Goblin War,2022-07-01,2,3,0,3,67.06,0
Dream of Light,2022-09-01,2,3,0,3,67.06,0
Hop Skip and Thump,2022-01-18,1,3,0,3,67.06,0
Bad Guy: Neighborhood,2022-06-16,5,3,0,3,67.06,0
Airborne Motocross,2022-04-08,2,3,0,3,67.06,0
Don't Get Distracted,2022-08-19,2,3,0,3,67.06,0
Where Is Here: New Home,2022-09-30,1,3,0,3,67.06,0
Blade Crusade,2022-09-30,2,3,0,3,67.06,0
Monster Fighter,2022-05-10,2,3,0,3,67.06,0
The Holy Chalice,2022-04-20,2,3,0,3,67.06,0
cursor0x0,2022-09-23,3,3,0,3,67.06,0
Curses of Tarot,2022-01-11,3,3,0,3,67.06,1
Letters from the Moon,2022-01-05,2,3,0,3,67.06,0
Station-Z,2022-12-22,3,3,0,3,67.06,0
How to Sing to Open Your Heart Remastered,2022-05-05,3,3,0,3,67.06,0
Spaceship Hunters,2022-01-31,4,3,0,3,67.06,0
Steph's Revenge,2022-01-04,1,3,0,3,67.06,0
遺跡冒險RelicAdventure,2022-01-29,2,3,0,3,67.06,0
Dream/strung - Blossoming Love,2022-02-12,5,3,0,3,67.06,0
Bathtime Toys,2022-03-03,3,3,0,3,67.06,0
Urchins & Ink,2022-07-29,2,3,0,3,67.06,0
Chromarena,2022-02-02,1,3,0,3,67.06,0
Beatus Creation Solitaire,2022-05-25,9,3,0,3,67.06,0
Primasia,2022-12-08,1,3,0,3,67.06,0
Spy Robot: Gateways To Humanity,2022-11-18,1,3,0,3,67.06,0
Netherspace 2,2022-01-07,2,3,0,3,67.06,0
Two World Portal,2022-01-14,3,3,0,3,67.06,0
Possession Obsession,2022-07-22,4,3,0,3,67.06,0
Slette Mette,2022-01-06,1,3,0,3,67.06,0
Brain Bait,2022-01-11,2,3,0,3,67.06,0
Khoros,2022-05-18,2,3,0,3,67.06,0
Milo,2022-02-02,1,3,0,3,67.06,0
Connected Hearts: The Full Moon Curse Collector's Edition,2022-01-25,5,3,0,3,67.06,1
Operation S,2022-01-11,3,3,0,3,67.06,0
Winter and People,2022-08-15,1,3,0,3,67.06,0
Pushing Crates,2022-09-06,2,3,0,3,67.06,0
American Christmas,2022-01-06,2,3,0,3,67.06,0
Fireflies & Figments: A Willow's Journey,2022-03-07,3,3,0,3,67.06,0
.G,2022-01-11,1,3,0,3,67.06,0
Helm or High Water,2022-02-17,3,3,0,3,67.06,0
Find the Gnome 2,2022-12-13,2,3,0,3,67.06,0
Bessarabian Nightmares,2022-02-09,2,3,0,3,67.06,0
Dark Paradise Nigelopia: Mini Mix,2022-01-21,2,3,0,3,67.06,0
Squarena,2022-03-01,4,3,0,3,67.06,0
The Hierophant,2022-02-02,2,3,0,3,67.06,0
FORTRESS OF FEAR,2022-02-01,2,3,0,3,67.06,0
Natural,2022-02-14,2,3,0,3,67.06,0
Fighting Heart,2022-02-11,2,3,0,3,67.06,0
素数ガール,2022-02-16,1,3,0,3,67.06,0
Dubu Rush,2022-03-19,1,3,0,3,67.06,0
Fantasy Mosaics 35: Day at the Museum,2022-01-27,6,3,0,3,67.06,0
Pillars of Sorrow,2022-09-23,2,3,0,3,67.06,0
Witch sacrifice,2022-02-13,2,3,0,3,67.06,0
Peep Invasion - Tower Defense,2022-05-04,1,3,0,3,67.06,0
Reds Adventure A Seasons New Beginning,2022-02-04,2,3,0,3,67.06,0
REAL LIFE OF SOLDIER,2022-02-18,2,3,0,3,67.06,0
ボクロボ ~Boxed Cell Robot Armies~,2022-05-25,10,3,0,3,67.06,0
Nuts Protocol,2022-07-12,2,3,0,3,67.06,0
Ark Defender,2022-07-11,3,3,0,3,67.06,0
Might of the Stones,2022-02-15,3,3,0,3,67.06,0
Skycliffs,2022-11-03,2,3,0,3,67.06,0
Lazerball,2022-12-09,3,3,0,3,67.06,0
Guns and Roses,2022-02-24,2,3,0,3,67.06,0
Journey To Destiny,2022-11-09,4,3,0,3,67.06,0
Fun Machine,2022-02-21,2,3,0,3,67.06,0
One Life,2022-12-16,2,3,0,3,67.06,0
MacShot,2022-03-10,2,3,0,3,67.06,0
Crupt,2022-04-28,4,3,0,3,67.06,0
Dumb Little Robots,2022-08-24,2,3,0,3,67.06,0
Master Show VR,2022-03-03,2,3,0,3,67.06,0
Hyperstrix,2022-05-10,1,3,0,3,67.06,0
SønderDø,2022-05-13,4,3,0,3,67.06,0
HellFull - The Last Hope,2022-03-15,2,3,0,3,67.06,0
俺に地球は狭すぎる,2022-03-04,3,3,0,3,67.06,0
Princess Pyro,2022-04-20,2,3,0,3,67.06,0
Alien Decimation,2022-09-02,1,3,0,3,67.06,0
Perfect Ball,2022-03-07,2,3,0,3,67.06,0
Hacking for Hermann,2022-05-11,3,3,0,3,67.06,0
Meliora,2022-10-31,4,3,0,3,67.06,0
Search and Rescue,2022-11-11,3,3,0,3,67.06,0
Super Gosu Cars,2022-09-23,6,3,0,3,67.06,0
Back 2 School,2022-03-10,2,3,0,3,67.06,0
Xpraize Beta for GameMaster,2022-05-31,3,3,0,3,67.06,0
Immortal Love: True Treasure Collector's Edition,2022-03-02,7,3,0,3,67.06,0
Spiriat,2022-08-02,2,3,0,3,67.06,0
Laruaville 12,2022-03-17,7,3,0,3,67.06,2
Voxquest: The Firebird,2022-03-17,1,3,0,3,67.06,0
Vacation Paradise: California Collector's Edition,2022-03-09,4,3,0,3,67.06,0
Reset Memory,2022-03-16,1,3,0,3,67.06,0
Space Voyager,2022-04-29,1,3,0,3,67.06,0
Pet Vet 3D Wild Animal Hospital,2022-04-21,4,3,0,3,67.06,0
Mystery Solitaire. Powerful Alchemist 2,2022-03-07,5,3,0,3,67.06,0
Underliner,2022-05-05,3,3,0,3,67.06,0
村雨のソードブレイカー,2022-04-03,3,3,0,3,67.06,0
Girbal,2022-11-01,3,3,0,3,67.06,0
Terry Poorflyer,2022-04-07,2,3,0,3,67.06,0
Darkness Of The Coast,2022-04-05,1,3,0,3,67.06,0
I wanna Reach the TOP,2022-12-31,2,3,0,3,67.06,0
Find And Kill The Evil King,2022-05-05,2,3,0,3,67.06,0
Holiday Jigsaw Easter 2,2022-03-30,1,3,0,3,67.06,0
GunQuest,2022-07-02,1,3,0,3,67.06,0
Groovy,2022-12-23,2,3,0,3,67.06,0
First Time in Rome,2022-08-26,6,3,0,3,67.06,0
Merge Cats - Idle Game,2022-04-13,3,3,0,3,67.06,0
Rotten Apple - New York Fallen,2022-09-02,4,3,0,3,67.06,0
Dash And Slash,2022-07-04,1,3,0,3,67.06,0
OneShotRogue,2022-06-20,2,3,0,3,67.06,0
Reforger,2022-11-01,4,3,0,3,67.06,0
怯懦 Cowardice,2022-11-16,2,3,0,3,67.06,0
Kokoro Ultimate,2022-05-16,2,3,0,3,67.06,0
Maps: U.S.A.,2022-05-30,2,3,0,3,67.06,0
I Love Finding MORE Pups,2022-07-15,3,3,0,3,67.06,1
Tower Of Wishes 2: Vikings,2022-05-28,6,3,0,3,67.06,1
Mist Monkey: wanderer,2022-09-13,2,3,0,3,67.06,0
午时已到,2022-05-02,3,3,0,3,67.06,0
HRS (Devil Game),2022-07-07,3,3,0,3,67.06,0
Automata Ecosystem,2022-05-31,2,3,0,3,67.06,0
Corridor Sigma,2022-05-04,2,3,0,3,67.06,0
Connected Hearts: Fortune Play Collector's Edition,2022-09-06,9,3,0,3,67.06,0
The Rhythm of the Knight,2022-05-26,1,3,0,3,67.06,0
Virtual Hunting Experience,2022-05-13,2,3,0,3,67.06,0
1001 Jigsaw. Legends of Mystery 6,2022-08-08,2,3,0,3,67.06,0
HyperNova,2022-06-20,2,3,0,3,67.06,0
Heart is Muscle,2022-10-14,1,3,0,3,67.06,0
Mosaics Galore. Glorious Journey,2022-08-08,2,3,0,3,67.06,0
Caterpillar,2022-06-02,1,3,0,3,67.06,0
The Twilight of Infinity,2022-07-01,2,3,0,3,67.06,0
Lost Bits,2022-06-22,4,3,0,3,67.06,0
Symmetry Lines,2022-05-18,4,3,0,3,67.06,0
Dungeon Fall,2022-05-16,1,3,0,3,67.06,0
封妖录,2022-05-18,3,3,0,3,67.06,0
Sky Captain's Return,2022-10-31,3,3,0,3,67.06,0
The Life of Arthur,2022-10-03,1,3,0,3,67.06,0
Lorethem,2022-05-25,1,3,0,3,67.06,0
Spellarium 8,2022-05-27,7,3,0,3,67.06,0
Arsolid Productions,2022-05-27,1,3,0,3,67.06,0
30 days in red army,2022-06-22,2,3,0,3,67.06,0
Chaotic Loop,2022-06-08,1,3,0,3,67.06,0
Death Bind,2022-07-07,4,3,0,3,67.06,0
Just Another Runner,2022-06-30,2,3,0,3,67.06,0
Arcade Flight,2022-06-06,1,3,0,3,67.06,0
Don't Stop the Camera! ~Hidden Desires of a Young Wife~,2022-06-24,2,3,0,3,67.06,0
Eternal,2022-12-22,2,3,0,3,67.06,0
Meat Beating: The Second Coming,2022-06-15,4,3,0,3,67.06,0
The Horace Trilogy,2022-06-24,1,3,0,3,67.06,0
Lil' Horror Stories: The Camp Fire,2022-06-28,2,3,0,3,67.06,0
Strange Investigations: Two for Solitaire Collector's Edition,2022-06-17,5,3,0,3,67.06,0
Cube Decider,2022-06-23,2,3,0,3,67.06,0
Doodle Drive,2022-07-26,2,3,0,3,67.06,0
Knights of the Kitchen Table,2022-07-01,2,3,0,3,67.06,0
Cat Lovescapes,2022-06-20,2,3,0,3,67.06,0
Trippy Tavern,2022-11-17,1,3,0,3,67.06,0
Project:EagleBeak,2022-09-02,4,3,0,3,67.06,0
Invasive,2022-07-20,1,3,0,3,67.06,0
Internet Exploring,2022-12-20,2,3,0,3,67.06,0
Quick Tower Defence Ultimate,2022-08-23,3,3,0,3,67.06,0
Operation: Forge the Deep,2022-11-29,3,3,0,3,67.06,0
Ein's Sword,2022-07-14,3,3,0,3,67.06,0
Alien Time,2022-09-22,2,3,0,3,67.06,0
Desstroke,2022-07-20,1,3,0,3,67.06,0
Wanted! Monty Mole,2022-07-01,2,3,0,3,67.06,0
Rock Wrecker,2022-07-14,6,3,0,3,67.06,0
Toggle Cube,2022-07-20,2,3,0,3,67.06,0
Space FURY - The Phantom Menace,2022-10-11,2,3,0,3,67.06,0
Platfuzzles,2022-09-05,2,3,0,3,67.06,0
Smash,2022-07-16,1,3,0,3,67.06,0
Rezzil Player,2022-12-21,3,3,0,3,67.06,0
Cursed Colors,2022-09-19,4,3,0,3,67.06,0
Jack the Nipper,2022-07-21,1,3,0,3,67.06,0
CYCLEBREAKER,2022-07-27,1,3,0,3,67.06,0
Berserker,2022-08-24,2,3,0,3,67.06,0
Berserker,2022-08-24,2,3,0,3,67.06,0
Berserker,2021-02-26,2,8,2,10,65.42,0
Berserker,2021-02-26,2,8,2,10,65.42,0
Shufflepoker,2022-08-30,3,3,0,3,67.06,0
Super Nova Party,2022-10-04,4,3,0,3,67.06,0
Slingshot Adventure,2022-08-22,1,3,0,3,67.06,0
Sleepy Sheep,2022-09-02,2,3,0,3,67.06,0
Lewis Carroll's Alice,2022-08-02,1,3,0,3,67.06,0
Retro Invasion,2022-08-24,2,3,0,3,67.06,0
MonkeyMilk,2022-08-08,1,3,0,3,67.06,0
Maze Ablaze,2022-08-10,2,3,0,3,67.06,0
Vacation Adventures: Park Ranger 14,2022-09-22,7,3,0,3,67.06,0
Path,2022-11-15,1,3,0,3,67.06,0
Path,2022-11-15,1,3,0,3,67.06,0
Path,2019-12-31,2,1,0,1,59.42,0
Path,2019-12-31,2,1,0,1,59.42,0
Angry Angus,2022-11-04,1,3,0,3,67.06,0
Cold Way,2022-11-11,2,3,0,3,67.06,0
Sharp Eyed,2022-09-05,2,3,0,3,67.06,0
Legend of Zero,2022-08-04,1,3,0,3,67.06,0
Nature Escapes,2022-11-07,5,3,0,3,67.06,0
